# -*- encoding: utf8 -*-
# 一级字 (3500)
一	A	A
乙	YDA
二	BD
十	ED
丁	AI
厂	GG
七	HD
卜	ID
八	O	A
人	OD
入	ODA
儿	RD
匕	RR
几	QD
九	QY
刁	𠃌 一
了	Y
刀	YD
力	YM
乃	Y 丿
又	XS
三	CD
干	一 十
于	一 D
亏	二 Z
工	BI
土	B	A
士	B
才	D 丿
下	一 卜
寸	DS
大	GD
丈	一 乂
与	一 Z 一
万	一 力
上	卜 一
小	KO
口	J	A
山	LL
巾	LI
千	ME
乞	𠂉 乙
川	ND
亿	亻 乙
个	人 丨
夕	RS
久	⺈ 丶
么	丿 厶
勺	勹 丶
凡	QDA
丸	QYA
及	Y 丿 丶	# 笔顺有误？
广	TG
亡	SH
门	TL
丫	丷 丨
义	丶 乂
之	W	A
尸	XM
己	YY
已	YYA
巳	YYB
弓	YZ
子	YA
卫	𠃌 一
也	YI
女	ZM
刃	刀 丶
飞	⺄ TD
习	YT
叉	又 丶
马	X	A
乡	Z ZM
丰	CI
王	C	A
开	一 廾
井	二 ND
天	一 大
夫	二 人
元	二 儿
无	一 尤
云	二 厶
专	二 Z 丶
丐	一 卜 Z
扎	扌 乚
艺	艹 乙
木	F	A
五	工 X
支	十 又
厅	厂 丁
不	GI
犬	大 丶
太	大 丶
区	匚 乂
历	厂 力
歹	一 夕
友	𠂇 又
尤	GR
匹	匚 儿
车	HE
巨	匚 X
牙	HI
屯	七 凵
戈	HM
比	匕 匕
互	二 ZM
切	七 刀
瓦	一 Z Y 丶
止	II
少	小 丿
曰	K
日	K	A
中	口 丨
贝	LO
冈	冂 乂
内	冂 人
水	KV
见	LR
午	𠂉 十
牛	MB
手	MD
气	MY
毛	MH
壬	丿 士
升	丿 廾
夭	丿 大
长	CH
仁	亻 二
什	亻 十
片	NX
仆	亻 卜
化	亻 匕
仇	亻 九
币	丿 巾
仍	亻 乃
仅	亻 又
斤	PD
爪	PV
反	⺁ 又
介	人 ND
父	八 乂
从	人 人
仑	人 匕
今	人 丶 X
凶	乂 凵
分	八 刀
乏	丿 之
公	八 厶
仓	人 ⺋
月	Q
氏	RH
勿	勹 OD
欠	RO
风	QD 乂
丹	Q 亠
匀	勹 冫
乌	RZA
勾	勹 厶
凤	QD 又
六	亠 八
文	SO
亢	亠 几
方	SY
火	UO
为	UD 𠃌 丶
斗	TD 十
忆	忄 乙
计	讠 十
订	讠 丁
户	WM
认	讠 人
冗	冖 几
讥	讠 几
心	WZ
尺	尸 丶
引	弓 丨
丑	X 十
巴	YIA
孔	子 乚
队	阝 人
办	力 八
以	厶 人
允	厶 儿
予	龴 乛 丨
邓	又 阝
劝	又 力
双	又 又
书	X 𠃌 丨 丶
幻	幺 𠃌
玉	CS
刊	干 刂
未	二 小
末	一 木
示	BK
击	BI 凵
打	扌 丁
巧	工 一 Z
正	一 止
扑	扌 卜
卉	十 廾
扒	扌 八
功	工 力
扔	扌 乃
去	土 厶
甘	EB
世	廿 Z
艾	艹 乂
古	十 口
节	艹 Y
本	木 一
术	木 丶
可	丁 口
丙	一 内
左	𠂇 工
厉	厂 万
石	G	A
右	𠂇 口
布	𠂇 巾
夯	大 力
戊	HM	AAA	# 强行设为HMAA，避开医、戌
龙	GM
平	一 UA
灭	一 火
轧	车 乚
东	七 小
卡	上 卜
北	丬 匕
占	卜 口
凸	丨 一 Y 一
卢	卜 尸
业	KU
旧	丨 日
帅	刂 巾
归	刂 彐
旦	日 一
目	L	A
且	LC
叶	口 十
甲	KIB
申	KIC
叮	口 丁
电	日 乚
号	口 一 Z
田	KI
由	KIA
只	口 八
叭	口 八
史	口 乂
央	冂 大
兄	口 儿
叽	口 几
叼	口 刁
叫	口 丩
叩	口 卩
叨	口 刀
另	口 力
叹	口 又
冉	冂 土
皿	LKA
凹	丨 Y 丨 X 一
囚	囗 人
四	LK
生	MC
矢	𠂉
失	MB 人
乍	𠂉 ID
禾	MF
丘	PDA
付	亻 寸
仗	亻 丈
代	亻 弋
仙	亻 山
们	亻 门
仪	亻 义
白	NK
仔	亻 子
他	亻 也
斥	斤 丶
瓜	PS
乎	丿 UA
丛	从 一
令	人 之
用	LD BI
甩	LD 乚
印	RH 一 卩
尔	⺈ 小
乐	RH 小
句	勹 口
匆	勿 丶
册	Q Q 一
卯	RH 丿 卩
犯	犭 ⺋
外	夕 卜
处	夂 卜
冬	夂 TD
鸟	RZ
务	夂 力
包	RY
饥	饣 几
主	丶 王
市	亠 巾
立	SU
冯	冫 马
玄	亠 幺
闪	门 人
兰	UA 二
半	UB
汁	氵 十
汇	氵 匚
头	TD 大
汉	氵 又
宁	宀 丁
穴	WO
它	宀 匕
讨	讠 寸
写	冖 与
让	讠 上
礼	礻 乚
训	讠 川
议	讠 义
必	心 丿
讯	讠 ⺄ 十
记	讠 己
永	SK
司	𠃌 一 口
尼	尸 匕
民	巳 七
弗	弓 ND
弘	弓 厶
出	屮 凵
辽	辶 了
奶	女 乃
奴	女 又
召	刀 口
加	力 口
皮	XI
边	辶 力
孕	乃 子
发	Z 丿 又 丶
圣	又 土
对	又 寸
台	厶 口
矛	予 丿
纠	纟 丩
母	ZY
幼	幺 力
丝	Z Z Z Z 一
邦	丰 阝
式	弋 工
迂	辶 于
刑	开 刂
戎	戈 𠂇
动	云 力
扛	扌 工
寺	土 寸
吉	士 口
扣	扌 口
考	耂 一 Z
托	扌 乇
老	耂 匕
巩	工 凡
圾	土 及
执	扌 丸
扩	扌 广
扫	扌 彐
地	土 也
场	土 Y OD
扬	扌 Y OD
耳	CE
芋	艹 于
共	廿 八
芒	艹 亡
亚	一 业
芝	艹 之
朽	木 一 Z
朴	木 卜
机	木 几
权	木 又
过	辶 寸
臣	H	A
吏	一 口 乂
再	一 冉
协	十 办
西	FJ
压	厂 土 丶
厌	厂 犬
戌	戊 一
在	𠂇 丨 土
百	一 白
有	𠂇 月
存	𠂇 丨 子
而	GL
页	GO
匠	匚 斤
夸	大 亏
夺	大 寸
灰	𠂇 火
达	辶 大
列	歹 刂
死	歹 匕
成	戊 𠃌
夹	二 火
夷	大 弓
轨	车 九
邪	牙 阝
尧	戈 兀
划	戈 刂
迈	辶 万
毕	比 十
至	HB
此	止 匕
贞	卜 贝
师	刂 一 巾
尘	小 土
尖	小 大
劣	少 力
光	小 兀
当	小 彐
早	日 十
吁	口 于
吐	口 土
吓	口 下
虫	I	A
曲	日 刂
团	囗 才
吕	口 口
同	LD
吊	口 巾
吃	口 乞
因	JD
吸	口 及
吗	口 马
吆	口 幺
屿	山 与
屹	山 乞
岁	山 夕
帆	巾 凡
回	囗 口
岂	山 己
则	贝 刂
刚	LD 刂
网	冂 乂 乂
肉	冂 人 人
年	𠂉 MB
朱	MB 小
先	牛 儿
丢	丿 去
廷	廴 壬
舌	MI
竹	𠂉 丨 𠂉 丨
迁	辶 千
乔	夭 ND
迄	辶 乞
伟	亻 韦
传	亻 专
乒	丘 丿
乓	丘 丶
休	亻 木
伍	亻 五
伏	亻 犬
优	亻 尤
臼	NB
伐	亻 戈
延	廴 丿 止	# 最后一笔是折也视为“止”的一部分
仲	亻 中
件	亻 牛
任	亻 壬
伤	亻 𠂉 力
价	亻 介
伦	亻 仑
份	亻 分
华	化 十
仰	亻 卬
仿	亻 方
伙	亻 火
伪	亻 为
自	NL
伊	亻 尹
血	丿 皿
向	NL 口
似	亻 以
后	⺁ 一 口
行	OI
舟	PY
全	人 王
会	人 云
杀	乂 木
合	人 一 口
兆	V 儿	# 不合笔顺
企	人 止
众	人 人 人
爷	父 Y
伞	人 UA
创	仓 刂
肌	月 几
肋	月 力
朵	几 木
杂	九 木
危	⺈ 厄
旬	勹 日
旨	匕 日
旭	九 日
负	⺈ 贝
匈	勹 凶
名	夕 口
各	夂 口
多	夕 夕
争	⺈ 肀
色	⺈ 巴
壮	丬 士
冲	冫 中
妆	丬 女
冰	冫 水
庄	广 土
庆	广 大
亦	亠 ND 八
刘	文 刂
齐	文 ND
交	亠 八 乂
衣	亠 氏
次	冫 欠
产	立 丿
决	冫 夬
亥	亠 ZM 人
充	亠 允
妄	亡 女
闭	门 才
问	门 口
闯	门 马
羊	UC
并	UA 廾
关	UA 大
米	UF
灯	火 丁
州	VD 川
汗	氵 干
污	氵 亏
江	氵 工
汛	氵 ⺄ 十
池	氵 也
汝	氵 女
汤	氵 Y OD
忙	忄 亡
兴	VD 一 八
宇	宀 于
守	宀 寸
宅	宀 乇
字	宀 子
安	宀 女
讲	讠 井
讳	讠 韦
军	冖 车
讶	讠 牙
许	讠 午
讹	讠 化
论	讠 仑
讼	讠 公
农	冖 氏
讽	讠 风
设	讠 殳
访	讠 方
诀	讠 夬
寻	彐 寸
那	𠃌 BI 阝
迅	辶 ⺄ 十
尽	尺 TD
导	巳 寸
异	巳 廾
弛	弓 也
孙	子 小
阵	阝 车
阳	阝 日
收	丩 攵
阶	阝 介
阴	阝 月
防	阝 方
奸	女 干
如	女 口
妇	女 彐
妃	女 己
好	女 子
她	女 也
妈	女 马
戏	又 戈
羽	习 习
观	又 见
欢	又 欠
买	乛 头
红	纟 工
驮	马 大
纤	纟 千
驯	马 川
约	纟 勺
级	纟 及
纪	纟 己
驰	马 也
纫	纟 刃
巡	辶 巛
寿	丰 寸
弄	王 廾
麦	丰 夂
玖	王 久
玛	王 马
形	开 彡
进	辶 井
戒	戈 廾
吞	天 口
远	辶 元
违	辶 韦
韧	韦 刃
运	辶 云
扶	扌 夫
抚	扌 无
坛	土 云
技	扌 支
坏	土 不
抠	扌 区
扰	扌 尤
扼	扌 厄
拒	扌 巨
找	扌 戈
批	扌 比
址	土 止
扯	扌 止
走	BO
抄	扌 少
贡	工 贝
汞	工 水
坝	土 贝
攻	工 攵
赤	土 ND 八
折	扌 斤
抓	扌 爪
扳	扌 反
抡	扌 仑
扮	扌 分
抢	扌 仓
孝	耂 子
坎	土 欠
均	土 匀
抑	扌 卬
抛	扌 九 力
投	扌 殳
坟	土 文
坑	土 亢
抗	扌 亢
坊	土 方
抖	扌 斗
护	扌 户
壳	士 冖 几
志	士 心
块	土 夬
扭	扌 丑
声	士 尸
把	扌 巴
报	扌 卩 又
拟	扌 以
却	去 卩
抒	扌 予
劫	去 力
芙	艹 夫
芜	艹 无
苇	艹 韦
芽	艹 牙
花	艹 化
芹	艹 斤
芥	艹 介
芬	艹 分
苍	艹 仓
芳	艹 方
严	亚 丿
芦	艹 户
芯	艹 心
劳	艹 冖 力
克	十 口 儿
芭	艹 巴
苏	艹 办
杆	木 干
杠	木 工
杜	木 土
材	木 才
村	木 寸
杖	木 丈
杏	木 口
杉	木 斤
巫	工 人 人
极	木 及
李	木 子
杨	木 Y OD
求	D V 丶
甫	FB
匣	匚 甲
更	一 日 乂
束	木 口
吾	五 口
豆	一 口 UA
两	一 冂 人 人
酉	FD
丽	一 LD LD
医	匚 矢
辰	GH
励	厉 力
否	不 口
还	辶 不
尬	尤 介
歼	歹 千
来	二 水
连	辶 车
轩	车 干
步	止 小
卤	卜 囗 乂
坚	刂 又 土
肖	小 月
旱	日 干
盯	目 丁
呈	口 王
时	日 寸
吴	口 天
助	且 力
县	且 厶
里	日 土
呆	口 木
吱	口 支
吠	口 犬
呕	口 区
园	囗 元
旷	日 广
围	囗 韦
呀	口 牙
吨	口 屯
足	JI
邮	由 阝
男	田 力
困	囗 木
吵	口 少
串	口 口 丨
员	口 贝
呐	口 内
听	口 斤
吟	口 今
吩	口 分
呛	口 仓
吻	口 勿
吹	口 欠
呜	口 乌
吭	口 亢
吧	口 巴
邑	口 巴
吼	口 孔
囤	囗 屯
别	另 刂
吮	口 允
岖	山 区
岗	山 LD
帐	巾 长
财	贝 才
针	钅 十
钉	钅 丁
牡	牛 土
告	牛 口
我	手 戈
乱	舌 乚
利	禾 刂
秃	禾 几
秀	禾 乃
私	禾 厶
每	𠂉 母
兵	丘 八
估	亻 古
体	亻 本
何	亻 可
佐	亻 左
佑	亻 右
但	亻 旦
伸	亻 申
佃	亻 田
作	亻 乍
伯	亻 白
伶	亻 令
佣	亻 LD
低	亻 氐
你	亻 尔
住	亻 主
位	亻 立
伴	亻 半
身	NC
皂	白 七
伺	亻 司
佛	亻 弗
囱	NJ 夕
近	辶 斤
彻	彳 切
役	彳 殳
返	辶 反
余	人 禾
希	乂 布
坐	人 人 土
谷	八 人 口
妥	爪 女
含	今 口
邻	令 阝
岔	分 山
肝	月 干
肛	月 工
肚	月 土
肘	月 寸
肠	月 Y OD
龟	⺈ 日 乚
甸	勹 田
免	⺈ 口 儿
狂	犭 王
犹	犭 尤
狈	犭 贝
角	⺈ LD
删	册 刂
条	夂 木
彤	丹 彡
卵	RH 丿 丶 卩 丶	# 先撇再点
灸	久 火
岛	鸟 山
刨	包 刂
迎	辶 卬
饭	饣 反
饮	饣 欠
系	丿 糸
言	S	A
冻	冫 东
状	丬 犬
亩	亠 田
况	冫 兄
床	广 木
库	广 车
庇	广 比
疗	疒 了
吝	文 口
应	广 VD 一
这	辶 文
冷	冫 令
庐	广 户
序	广 予
辛	SE
弃	亠 厶 廾
冶	冫 台
忘	亡 心
闰	门 王
闲	门 木
间	门 日
闷	门 心
判	半 刂
兑	丷 兄
灶	火 土
灿	火 山
灼	火 勺
弟	丷 YZ
汪	氵 王
沐	氵 木
沛	氵 一 巾
汰	氵 太
沥	氵 历
沙	氵 少
汽	氵 气
沃	氵 夭
沦	氵 仑
汹	氵 凶
泛	氵 乏
沧	氵 仓
没	氵 殳
沟	氵 勾
沪	氵 户
沈	氵 冖 儿
沉	氵 冖 几
沁	氵 心
怀	忄 不
忧	忄 尤
忱	忄 冖 儿
快	忄 夬
完	宀 元
宋	宀 木
宏	宀 𠂇 厶
牢	宀 牛
究	穴 九
穷	穴 力
灾	宀 火
良	丶 艮
证	讠 正
启	户 口
评	讠 平
补	衤 卜
初	衤 刀
社	礻 土
祀	礻 巳
识	讠 只
诈	讠 乍
诉	讠 斥
罕	⺳ 干
诊	讠 人 彡
词	讠 司
译	讠 又 BI
君	尹 口
灵	彐 火
即	艮 卩
层	尸 云
屁	尸 比
尿	尸 水
尾	尸 毛
迟	辶 尺
局	尸 𠃌 口
改	己 攵
张	弓 长
忌	己 心
际	阝 示
陆	阝 击
阿	阝 可
陈	阝 东
阻	阝 且
附	阝 付
坠	队 土
妓	女 支
妙	女 少
妖	女 夭
姊	女 丿 Z 丨 丿
妨	女 方
妒	女 户
努	奴 力
忍	刃 心
劲	XS 工 力
矣	厶 矢
鸡	又 鸟
纬	纟 韦
驱	马 区
纯	纟 屯
纱	纟 少
纲	纟 LD
纳	纟 内
驳	马 乂 乂
纵	纟 从
纷	纟 分
纸	纟 氏
纹	纟 文
纺	纟 方
驴	马 户
纽	纟 丑
奉	𡗗 BI
玩	王 元
环	王 不
武	一 弋 止
青	丰 月
责	丰 贝
现	王 见
玫	王 攵
表	丰 氏
规	夫 见
抹	扌 末
卦	圭 卜
坷	土 可
坯	土 丕
拓	扌 石
拢	扌 龙
拔	扌 友 丶
坪	土 平
拣	扌 七 𠃌 八
坦	土 日 一
担	扌 日 一
坤	土 申
押	扌 甲
抽	扌 由
拐	扌 另
拖	扌 𠂉 也
者	BM
拍	扌 白
顶	丁 页
拆	扌 斥
拎	扌 令
拥	扌 LD
抵	扌 氐
拘	扌 句
势	执 力
抱	扌 包
拄	扌 主
垃	土 立
拉	扌 立
拦	扌 兰
幸	土 半
拌	扌 半
拧	扌 宁
拂	扌 弗
拙	扌 出
招	扌 召
坡	土 皮
披	扌 皮
拨	扌 发
择	扌 又 BI
抬	扌 台
拇	扌 母
拗	扌 幼
其	EC
取	耳 又
茉	艹 末
苦	艹 古
昔	廿 日
苛	艹 可
若	艹 右
茂	艹 戊
苹	艹 平
苗	艹 田
英	艹 央
苟	艹 句
苑	艹 夕 ⺋
苞	艹 包
范	艹 氵 ⺋
直	十 LC
茁	艹 出
茄	艹 加
茎	艹 XS 工
苔	艹 台
茅	艹 矛
枉	木 王
林	木 木
枝	木 支
杯	木 不
枢	木 区
柜	木 巨
枚	木 攵
析	木 斤
板	木 反
松	木 公
枪	木 仓
枫	木 风
构	木 勾
杭	木 亢
杰	木 灬
述	辶 术
枕	木 冖 儿
丧	十 丷 H
或	戈 口 一
画	一 田 凵
卧	臣 卜
事	D 口 彐
刺	木 冂 刂
枣	木 冂 TD
雨	FV
卖	十 乛 头
郁	有 阝
矾	石 凡
矿	石 广
码	石 马
厕	厂 则
奈	大 示
奔	大 卉
奇	大 可
奋	大 田
态	太 心
欧	区 欠
殴	区 殳
垄	龙 土
妻	一 彐 女
轰	车 双
顷	匕 页
转	车 专
斩	车 斤
轮	车 仑
软	车 欠
到	至 刂
非	KC
叔	上 小 又
歧	止 支
肯	止 月
齿	IO
些	此 二
卓	卜 早
虎	IH
虏	虍 力
肾	刂 又 月
贤	刂 又 贝
尚	小 LD
旺	日 王
具	LC 八
味	口 未
果	日 木
昆	日 比
国	囗 玉
哎	口 艾
咕	口 古
昌	日 日
呵	口 可
畅	申 Y OD
明	日 月
易	日 勿
咙	口 龙
昂	日 卬
迪	辶 由
典	冂 共
固	囗 古
忠	中 心
呻	口 申
咒	口 口 几
咋	口 乍
咐	口 付
呼	口 乎
鸣	口 鸟
咏	口 永
呢	口 尼
咄	口 出
咖	口 加
岸	山 厂 干
岩	山 石
帖	巾 占
罗	四 夕
帜	巾 只
帕	巾 白
岭	山 令
凯	岂 几
败	贝 攵
账	贝 长
贩	贝 反
贬	贝 乏
购	贝 勾
贮	贝 宀 一
图	囗 冬
钓	钅 勺
制	MB 巾 刂
知	矢 口
迭	辶 失
氛	气 分
垂	千 艹 二
牧	牛 攵
物	牛 勿
乖	千 北
刮	舌 刂
秆	禾 干
和	禾 口
季	禾 子
委	禾 女
秉	禾 彐
佳	亻 圭
侍	亻 寺
岳	丘 山
供	亻 共
使	亻 吏
例	亻 列
侠	亻 夹
侥	亻 尧
版	片 反
侄	亻 至
侦	亻 贞
侣	亻 吕
侧	亻 则
凭	任 几
侨	亻 乔
佩	亻 几 一 巾
货	化 贝
侈	亻 多
依	亻 衣
卑	NJ 十
的	白 勺
迫	辶 白
质	⺁ 十 贝
欣	斤 欠
征	彳 正
往	彳 主
爬	爪 巴
彼	彳 皮
径	彳 XS 工
所	⺁ X 斤
舍	人 舌
金	P	A
刹	杀 刂
命	人 一 口 卩
肴	乂 有
斧	父 斤
爸	父 巴
采	爪 木
觅	爪 见
受	爪 冖 又
乳	孚 乚
贪	今 贝
念	今 心
贫	分 贝
忿	分 心
肤	月 夫
肺	月 一 巾
肢	月 支
肿	月 中
胀	月 长
朋	月 月
股	月 殳
肮	月 亢
肪	月 方
肥	月 巴
服	月 卩 又
胁	月 办
周	LD 土 口
昏	氏 日
鱼	R	A
兔	免 丶
狐	犭 瓜
忽	勿 心
狗	犭 句
狞	犭 宁
备	夂 田
饰	饣 𠂉 巾
饱	饣 包
饲	饣 司
变	SK 又
京	亠 口 小
享	亠 口 子
庞	广 龙
店	广 占
夜	亠 亻 夕
庙	广 由
府	广 付
底	广 氐
疟	疒 H
疙	疒 乞
疚	疒 久
剂	齐 刂
卒	亠 人 人 十
郊	交 阝
庚	广 彐 人
废	广 发
净	冫 争
盲	亡 目
放	方 攵
刻	亥 刂
育	亠 厶 月
氓	亡 民
闸	门 甲
闹	门 市
郑	关 阝
券	龹 刀
卷	龹 ⺋
单	丷 日 十
炬	火 巨
炒	火 少
炊	火 欠
炕	火 亢
炎	火 火
炉	火 户
沫	氵 末
浅	氵 戈
法	氵 去
泄	氵 世
沽	氵 古
河	氵 可
沾	氵 占
泪	氵 目
沮	氵 且
油	氵 由
泊	氵 白
沿	氵 几 口
泡	氵 包
注	氵 主
泣	氵 立
泞	氵 宁
泻	氵 写
泌	氵 必
泳	氵 永
泥	氵 尼
沸	氵 弗
沼	氵 召
波	氵 皮
泼	氵 发
泽	氵 又 BI
治	氵 台
怔	忄 正
怯	忄 去
怖	忄 布
性	忄 生
怕	忄 白
怜	忄 令
怪	忄 圣
怡	忄 台
学	VD 冖 子
宝	宀 玉
宗	宀 示
定	WD
宠	宀 龙
宜	宀 且
审	宀 申
宙	宀 由
官	宀 Y
空	穴 工
帘	穴 巾
宛	宀 夕 ⺋
实	宀 头
试	讠 式
郎	丶 艮 阝
诗	讠 寺
肩	户 月
房	户 方
诚	讠 成
衬	衤 寸
衫	衤 彡
视	礻 见
祈	礻 斤
话	讠 舌
诞	讠 延
诡	讠 危
询	讠 旬
该	讠 亥
详	讠 羊
建	廴 聿
肃	肀 ND 八
录	彐 水
隶	彐 水
帚	彐 冖 巾
屉	尸 世
居	尸 古
届	尸 由
刷	尸 巾 刂
屈	尸 出
弧	弓 瓜
弥	弓 尔
弦	弓 玄
承	乛 水 三
孟	子 皿
陋	阝 Z 丙
陌	阝 百
孤	子 瓜
陕	阝 夹
降	阝 夂 牛
函	乛 水 凵
限	阝 艮
妹	女 未
姑	女 古
姐	女 且
姓	女 生
妮	女 尼
始	女 台
姆	女 母
迢	辶 召
驾	加 马
叁	厶 大 三
参	厶 大 彡
艰	又 艮
线	纟 戈
练	纟 七 𠃌 八
组	纟 且
绅	纟 申
细	纟 田
驶	马 史
织	纟 只
驹	马 句
终	纟 冬
驻	马 主
绊	纟 半
驼	马 它
绍	纟 召
绎	纟 又 BI
经	纟 XS 工
贯	母 贝
契	丰 刀 大
贰	弋 二 贝
奏	𡗗 天
春	CO
帮	邦 巾
玷	王 占
珍	王 人 彡
玲	王 令
珊	王 册
玻	王 皮
毒	丰 母
型	刑 土
拭	扌 式
挂	扌 圭
封	圭 寸
持	扌 寺
拷	扌 考
拱	扌 共
项	工 页
垮	土 夸
挎	扌 夸
城	土 成
挟	扌 夹
挠	扌 尧
政	正 攵
赴	走 卜
赵	走 乂
挡	扌 当
拽	扌 曳
哉	𢦏 口
挺	扌 廷
括	扌 舌
垢	土 后
拴	扌 全
拾	扌 合
挑	扌 兆
垛	土 朵
指	扌 旨
垫	执 土
挣	扌 争
挤	扌 齐
拼	扌 并
挖	扌 穴 乙
按	扌 安
挥	扌 军
挪	扌 那
拯	扌 丞
某	甘 木
甚	其 Z
荆	艹 开 刂
茸	艹 耳
革	EE
茬	艹 在
荐	艹 存
巷	廿 八 巳
带	E 冖 巾
草	艹 早
茧	艹 虫
茵	艹 因
茶	艹 人 木
荒	艹 亡 川
茫	艹 氵 亡
荡	艹 汤
荣	艹 冖 木
荤	艹 军
荧	艹 冖 火
故	古 攵
胡	古 月
荫	艹 阴
荔	艹 力 力 力
南	十 LD
药	艹 约
标	木 示
栈	木 戈
柑	木 甘
枯	木 古
柄	木 丙
栋	木 东
相	木 目
查	木 旦
柏	木 白
栅	木 册
柳	木 卯
柱	木 主
柿	木 市
栏	木 兰
柠	木 宁
树	木 对
勃	孛 力
要	西 女
柬	木 四
咸	戊 一 口
威	戊 一 女
歪	不 正
研	石 开
砖	石 专
厘	厂 里
厚	厂 日 子
砌	石 切
砂	石 少
泵	石 水
砚	石 见
砍	石 欠
面	丆 囗 KD
耐	而 寸
耍	而 女
牵	大 冖 牛
鸥	区 鸟
残	歹 戈
殃	歹 央
轴	车 由
轻	车 XS 工
鸦	牙 鸟
皆	比 白
韭	非 一
背	北 月
战	占 戈
点	占 灬
虐	虍 H
临	刂 M K
览	刂 M 见
竖	刂 又 立
省	少 目
削	肖 刂
尝	龸 云
昧	日 未
盹	目 屯
是	日 一 止
盼	目 分
眨	目 乏
哇	口 圭
哄	口 共
哑	口 亚
显	日 业
冒	日 目
映	日 央
星	日 生
昨	日 乍
咧	口 列
昭	日 召
畏	田 H
趴	足 八
胃	田 月
贵	中 一 贝
界	田 介
虹	虫 工
虾	虫 下
蚁	虫 义
思	田 心
蚂	虫 马
虽	口 虫
品	口 口 口
咽	口 因
骂	口 口 马
勋	员 力
哗	口 华
咱	口 自
响	口 向
哈	口 合
哆	口 多
咬	口 交
咳	口 亥
咪	口 米
哪	口 那
哟	口 约
炭	山 灰
峡	山 夹
罚	四 讠 刂
贱	贝 戈
贴	贝 占
贻	贝 台
骨	LW
幽	幺 幺 山
钙	钅 丐
钝	钅 屯
钞	钅 少
钟	钅 中
钢	钅 LD
钠	钅 内
钥	钅 月
钦	钅 欠
钧	钅 匀
钩	钅 勾
钮	钅 丑
卸	𠂉 一 止 卩
缸	缶 工
拜	手 一 丰
看	手 目
矩	矢 巨
毡	毛 占
氢	气 XS 工
怎	乍 心
牲	牛 生
选	辶 先
适	辶 舌
秒	禾 少
香	禾 日
种	禾 中
秋	禾 火
科	禾 斗
重	千 日 二
复	𠂉 日 夂
竿	⺮ 干
段	亻 三 殳
便	亻 更
俩	亻 两
贷	代 贝
顺	川 页
修	亻 丨 夂 彡
俏	亻 肖
保	亻 呆
促	亻 足
俄	亻 我
俐	亻 利
侮	亻 每
俭	亻 佥
俗	亻 谷
俘	亻 孚
信	亻 言
皇	白 王
泉	白 水
鬼	NJ
侵	亻 彐 冖 又
禹	丿 虫 冂
侯	亻 X 矢
追	辶 丿 Y
俊	亻 厶 八 夂
盾	⺁ 十 目
待	彳 寺
徊	彳 回
衍	行 氵
律	彳 聿
很	彳 艮
须	彡 页
叙	余 又
剑	佥 刂
逃	辶 兆
食	OX
盆	分 皿
胚	月 丕
胧	月 龙
胆	月 旦
胜	月 生
胞	月 包
胖	月 半
脉	月 永
胎	月 台
勉	免 力
狭	犭 夹
狮	犭 师
独	犭 虫
狰	犭 争
狡	犭 交
狱	犭 讠 犬
狠	犭 艮
贸	RH 丶 刀 贝
怨	夕 ⺋ 心
急	刍 心
饵	饣 耳
饶	饣 尧
蚀	饣 虫
饺	饣 交
饼	饣 并
峦	SK 山
弯	SK 弓
将	丬 夕 寸
奖	丬 夕 大
哀	亠 口 氏
亭	亠 口 冖 丁
亮	亠 口 冖 几
度	广 廿 又
迹	辶 亦
庭	广 廷
疮	疒 仓
疯	疒 风
疫	疒 殳
疤	疒 巴
咨	次 口
姿	次 女
亲	立 木
音	立 日
帝	亠 丷 冖 巾
施	方 𠂉 也
闺	门 圭
闻	门 耳
闽	门 虫
阀	门 伐
阁	门 各
差	羊 工
养	UC ND
美	羊 大
姜	羊 女
叛	半 反
送	辶 关
类	米 大
迷	辶 米
籽	米 子
娄	米 女
前	UA 月 刂
首	UA 自
逆	辶 UA 屮
兹	UA 幺 幺
总	丷 口 心
炼	火 七 𠃌 八
炸	火 乍
烁	火 乐
炮	火 包
炫	火 玄
烂	火 兰
剃	弟 刂
洼	氵 圭
洁	氵 吉
洪	氵 共
洒	氵 西
柒	氵 七 木
浇	氵 尧
浊	氵 虫
洞	氵 同
测	氵 则
洗	氵 先
活	氵 舌
派	氵 ⺁ 氏
洽	氵 合
染	氵 九 木
洛	氵 各
浏	氵 刘
济	氵 齐
洋	氵 羊
洲	氵 州
浑	氵 军
浓	氵 农
津	氵 聿
恃	忄 寺
恒	忄 亘
恢	忄 灰
恍	忄 光
恬	忄 舌
恤	忄 血
恰	忄 合
恼	忄 亠 凶
恨	忄 艮
举	兴 BI
觉	VD 冖 见
宣	宀 亘
宦	宀 臣
室	宀 至
宫	宀 吕
宪	宀 先
突	穴 犬
穿	穴 牙
窃	穴 切
客	宀 各
诫	讠 戒
冠	冖 元 寸
诬	讠 巫
语	讠 吾
扁	户 LD
袄	衤 夭
祖	礻 且
神	礻 申
祝	礻 兄
祠	礻 司
误	讠 吴
诱	讠 秀
诲	讠 每
说	讠 兑
诵	讠 甬
垦	艮 土
退	辶 艮
既	艮 H 儿
屋	尸 至
昼	尺 旦
屏	尸 并
屎	尸 米
费	弗 贝
陡	阝 走
逊	辶 孙
眉	尸 目
孩	子 亥
陨	阝 员
除	阝 余
险	阝 佥
院	阝 完
娃	女 圭
姥	女 老
姨	女 夷
姻	女 因
娇	女 乔
姚	女 兆
娜	女 那
怒	奴 心
架	加 木
贺	加 贝
盈	乃 又 皿
勇	甬 力
怠	台 心
癸	癶 天
蚤	叉 虫
柔	矛 木
垒	厶 厶 厶 土
绑	纟 邦
绒	纟 戎
结	纟 吉
绕	纟 尧
骄	马 乔
绘	纟 会
给	纟 合
绚	纟 旬
骆	马 各
络	纟 各
绝	纟 色
绞	纟 交
骇	马 亥
统	纟 充
耕	耒 井
耘	耒 云
耗	耒 毛
耙	耒 巴
艳	丰 色
泰	𡗗 水
秦	𡗗 禾
珠	王 朱
班	王 UD 王
素	丰 糸
匿	匚 若
蚕	天 虫
顽	元 页
盏	戈 皿
匪	匚 非
捞	扌 劳
栽	EH
捕	扌 甫
埂	土 更
捂	扌 吾
振	扌 辰
载	𢦏 车
赶	走 干
起	走 己
盐	土 卜 皿
捎	扌 肖
捍	扌 旱
捏	扌 日 土
埋	土 里
捉	扌 足
捆	扌 困
捐	扌 口 月
损	扌 口 贝
袁	土 口 氏
捌	扌 别
都	者 阝
哲	折 口
逝	辶 折
捡	扌 佥
挫	扌 坐
换	扌 奂
挽	扌 免
挚	执 手
热	执 灬
恐	巩 心
捣	扌 岛
壶	士 冖 业
捅	扌 甬
埃	土 矣
挨	扌 矣
耻	耳 止
耿	耳 火
耽	耳 冖 儿
聂	耳 双
恭	廿 八 ⺗
莽	艹 犬 艹
莱	艹 来
莲	艹 连
莫	艹 日 大
莉	艹 利
荷	艹 何
获	艹 犭 犬
晋	亚 日
恶	亚 心
莹	艹 冖 玉
莺	艹 冖 鸟
真	十 具
框	木 匡
梆	木 邦
桂	木 圭
桔	木 吉
栖	木 西
档	木 当
桐	木 同
株	木 朱
桥	木 乔
桦	木 华
栓	木 全
桃	木 兆
格	木 各
桩	木 庄
校	木 交
核	木 亥
样	木 羊
根	木 艮
索	十 冖 糸
哥	可 可
速	辶 束
逗	辶 豆
栗	西 木
贾	西 贝
酌	酉 勺
配	酉 己
翅	支 羽
辱	辰 寸
唇	辰 口
夏	一 自 夂
砸	石 匝
砰	石 平
砾	石 乐
础	石 出
破	石 皮
原	厂 白 小
套	大 CH
逐	辶 豕
烈	列 灬
殊	歹 朱
殉	歹 旬
顾	厄 页
轿	车 乔
较	车 交
顿	屯 页
毙	比 死
致	至 攵
柴	此 木
桌	卜 日 木
虑	虍 心
监	刂 M 皿
紧	刂 又 糸
党	龸 兄
逞	辶 呈
晒	日 西
眠	目 民
晓	日 尧
哮	口 孝
唠	口 劳
鸭	甲 鸟
晃	日 光
哺	口 甫
晌	日 向
剔	易 刂
晕	日 军
蚌	虫 丰
畔	田 半
蚣	虫 公
蚊	虫 文
蚪	虫 斗
蚓	虫 引
哨	口 肖
哩	口 里
圃	囗 甫
哭	口 口 犬
哦	口 我
恩	因 心
鸯	央 鸟
唤	口 奂
唁	口 言
哼	口 亨
唧	口 即
啊	口 阿
唉	口 矣
唆	口 厶 八 夂
罢	四 去
峭	山 肖
峨	山 我
峰	山 夂 丰
圆	囗 员
峻	山 厶 八 夂
贼	贝 戎
贿	贝 有
赂	贝 各
赃	贝 庄
钱	钅 戈
钳	钅 甘
钻	钅 占
钾	钅 甲
铁	钅 失
铃	钅 令
铅	钅 几 口
缺	缶 夬
氧	气 羊
氨	气 安
特	牛 寺
牺	牛 西
造	辶 告
乘	禾 北
敌	舌 攵
秤	禾 平
租	禾 且
积	禾 只
秧	禾 央
秩	禾 失
称	禾 尔
秘	禾 必
透	辶 秀
笔	⺮ 毛
笑	⺮ 夭
笋	⺮ 尹
债	亻 责
借	亻 昔
值	亻 直
倚	亻 奇
俺	亻 奄
倾	亻 顷
倒	亻 到
倘	亻 尚
俱	亻 具
倡	亻 昌
候	亻 丨 X 矢
赁	任 贝
俯	亻 府
倍	亻 立 口
倦	亻 卷
健	亻 建
臭	自 犬
射	身 寸
躬	身 弓
息	自 心
倔	亻 屈
徒	彳 走
徐	彳 余
殷	⺁ 彐 𠃌 殳
舰	舟 见
舱	舟 仓
般	舟 殳
航	舟 亢
途	辶 余
拿	合 手
耸	人 人 耳
爹	父 多
舀	爪 臼
爱	爪 冖 友
豺	豸 才
豹	豸 勺
颁	分 页
颂	公 页
翁	公 羽
胰	月 夷
脆	月 危
脂	月 旨
胸	月 匈
胳	月 各
脏	月 庄
脐	月 齐
胶	月 交
脑	月 亠 凶
脓	月 农
逛	辶 狂
狸	犭 里
狼	犭 良
卿	RH 丿 即
逢	辶 夂 丰
鸵	鸟 它
留	RH 丶 刀 田
鸳	夕 ⺋ 鸟
皱	刍 皮
饿	饣 我
馁	饣 妥
凌	冫 土 八 夂
凄	冫 妻
恋	SK 心
桨	丬 夕 木
浆	丬 夕 水
衰	亠 日 氏
衷	亠 中 氏
高	亠 口 LD
郭	享 阝
席	广 廿 巾
准	冫 隹
座	广 坐
症	疒 正
病	T	A
疾	疒 矢
斋	文 而
疹	疒 人 彡
疼	疒 冬
疲	疒 皮
脊	V 人 月
效	交 攵
离	亠 凶 LD 厶
紊	文 糸
唐	广 肀 口
瓷	次 瓦
资	次 贝
凉	冫 京
站	立 占
剖	立 口 刂
竞	立 兄
部	立 口 阝
旁	亠 丷 冖 方
旅	方 𠂉 氏
畜	玄 田
阅	门 兑
羞	羊 丑
羔	羊 灬
瓶	并 瓦
拳	龹 手
粉	米 分
料	米 斗
益	UA 八 皿
兼	UA XK
烤	火 考
烘	火 共
烦	火 页
烧	火 尧
烛	火 虫
烟	火 因
烙	火 各
递	辶 弟
涛	氵 寿
浙	氵 折
涝	氵 劳
浦	氵 甫
酒	氵 酉
涉	氵 步
消	氵 肖
涡	氵 呙
浩	氵 告
海	氵 每
涂	氵 余
浴	氵 谷
浮	氵 孚
涣	氵 奂
涤	氵 条
流	氵 亠 厶 川
润	氵 闰
涧	氵 间
涕	氵 弟
浪	氵 良
浸	氵 彐 冖 又
涨	氵 张
烫	汤 火
涩	氵 刃 止
涌	氵 甬
悖	忄 孛
悟	忄 吾
悄	忄 肖
悍	忄 旱
悔	忄 每
悯	忄 门 文
悦	忄 兑
害	宀 丰 口
宽	宀 艹 见
家	宀 豕
宵	宀 肖
宴	宀 日 女
宾	宀 兵
窍	穴 巧
窄	穴 乍
容	穴 人 口
宰	宀 辛
案	安 木
请	讠 青
朗	丶 艮 月
诸	讠 者
诺	讠 若
读	讠 卖
扇	户 羽
诽	讠 非
袜	衤 末
袖	衤 由
袍	衤 包
被	衤 皮
祥	礻 羊
课	讠 果
冥	冖 日 六
谁	讠 隹
调	讠 周
冤	冖 兔
谅	讠 京
谆	讠 享
谈	讠 炎
谊	讠 宜
剥	录 刂
恳	艮 心
展	尸 艹 H
剧	居 刂
屑	尸 肖
弱	弓 冫 弓 冫
陵	阝 土 八 夂
祟	出 示
陶	阝 勹 缶
陷	阝 ⺈ 臼
陪	阝 立 口
娱	女 吴
娟	女 口 月
恕	如 心
娥	女 我
娘	女 良
通	辶 甬
能	厶 月 匕 匕
难	又 隹
预	予 页
桑	又 又 又 木
绢	纟 口 月
绣	纟 秀
验	马 佥
继	纟 Z 米
骏	马 厶 八 夂
球	王 求
琐	王 小 贝
理	王 里
琉	王 亠 厶 川
琅	王 良
捧	扌 奉
堵	土 者
措	扌 昔
描	扌 苗
域	土 或
捺	扌 奈
掩	扌 奄
捷	扌 一 彐 止
排	扌 非
焉	正 一 Z 灬
掉	扌 卓
捶	扌 垂
赦	赤 攵
堆	土 隹
推	扌 隹
埠	土 阜
掀	扌 欣
授	扌 受
捻	扌 念
教	孝 攵
掏	扌 勹 缶
掐	扌 ⺈ 臼
掠	扌 京
掂	扌 店
培	土 立 口
接	扌 妾
掷	扌 郑
控	扌 空
探	扌 ⺳ 木
据	扌 居
掘	扌 屈
掺	扌 参
职	耳 只
基	其 土
聆	耳 令
勘	甚 力
聊	耳 卯
娶	取 女
著	艹 者
菱	艹 土 八 夂
勒	革 力
黄	廿 由 八
菲	艹 非
萌	艹 明
萝	艹 罗
菌	艹 囷
萎	艹 委
菜	艹 采
萄	艹 勹 缶
菊	艹 勹 米
菩	艹 立 口
萍	艹 氵 平
菠	艹 波
萤	艹 冖 虫
营	艹 冖 吕
乾	龺 乞
萧	艹 肃
萨	艹 阝 产
菇	艹 姑
械	木 戒
彬	林 彡
梦	林 夕
婪	林 女
梗	木 更
梧	木 吾
梢	木 肖
梅	木 每
检	木 佥
梳	木 亠 厶 川
梯	木 弟
桶	木 甬
梭	木 厶 八 夂
救	求 攵
曹	艹 日 日
副	一 口 田 刂
票	西 示
酝	酉 云
酗	酉 凶
厢	厂 相
戚	戊 上 小
硅	石 圭
硕	石 页
奢	大 者
盔	灰 皿
爽	大 乂 乂 乂 乂
聋	龙 耳
袭	龙 衣
盛	成 皿
匾	匚 扁
雪	雨 彐
辅	车 甫
辆	车 两
颅	卢 页
虚	虍 业
彪	虎 彡
雀	小 隹
堂	龸 口 土
常	龸 吊
眶	目 匡
匙	是 匕
晨	日 辰
睁	目 争
眯	目 米
眼	目 艮
悬	县 心
野	里 予
啪	口 拍
啦	口 拉
曼	日 四 又
晦	日 每
晚	日 免
啄	口 豕 丶
啡	口 非
距	足 巨
趾	足 止
啃	口 肯
跃	足 夭
略	田 各
蚯	虫 丘
蛀	虫 主
蛇	虫 它
唬	口 虎
累	田 糸
鄂	口 口 亏 阝
唱	口 昌
患	串 心
啰	口 罗
唾	口 垂
唯	口 隹
啤	口 卑
啥	口 舍
啸	口 肃
崖	山 厂 圭
崎	山 奇
崭	山 斩
逻	辶 罗
崔	山 隹
帷	巾 隹
崩	山 朋
崇	山 宗
崛	山 屈
婴	贝 贝 女
圈	囗 卷
铐	钅 考
铛	钅 当
铝	钅 吕
铜	钅 同
铭	钅 名
铲	钅 产
银	钅 艮
矫	矢 乔
甜	舌 甘
秸	禾 吉
梨	利 木
犁	利 牛
秽	禾 岁
移	禾 多
笨	⺮ 本
笼	⺮ 龙
笛	⺮ 由
笙	⺮ 生
符	⺮ 付
第	⺮ YZ
敏	每 攵
做	亻 故
袋	代 衣
悠	攸 心
偿	亻 尝
偶	亻 禺
偎	亻 畏
偷	亻 俞
您	你 心
售	隹 口
停	亻 亭
偏	亻 扁
躯	身 区
兜	RH 白 X 儿	# 不合笔顺？
假	亻 叚
衅	血 半
徘	彳 非
徙	彳 止 止
得	彳 日 一 寸
衔	行 钅
盘	舟 皿
舶	舟 白
船	舟 几 口
舵	舟 它
斜	余 斗
盒	合 皿
鸽	合 鸟
敛	佥 攵
悉	釆 心
欲	谷 欠
彩	采 彡
领	令 页
脚	月 去 卩
脖	月 孛
脯	月 甫
豚	月 豕
脸	月 佥
脱	月 兑
象	⺈ 口 豕
够	句 多
逸	辶 兔
猜	犭 青
猪	犭 者
猎	犭 昔
猫	犭 苗
凰	几 皇
猖	犭 昌
猛	犭 孟
祭	RS 示
馅	饣 ⺈ 臼
馆	饣 官
凑	冫 奏
减	冫 咸
毫	亠 口 冖 毛
烹	亨 灬
庶	广 廿 灬
麻	广 林
庵	广 奄
痊	疒 全
痒	疒 羊
痕	疒 艮
廊	广 郎
康	广 隶
庸	广 肀 LD
鹿	TX
盗	次 皿
章	立 早
竟	立 日 儿
商	亠 丷 LD
族	方 𠂉 矢
旋	方 𠂉 疋
望	亡 月 王
率	亠 V 幺 十	# 不合笔顺有误
阎	门 ⺈ 臼
阐	门 单
着	羊 目
羚	羊 令
盖	羊 皿
眷	龹 目
粘	米 占
粗	米 且
粒	米 立
断	Z 米 斤
剪	前 刀
兽	丷 田 一 口
焊	火 旱
焕	火 奂
清	氵 青
添	氵 忝
鸿	氵 工 鸟
淋	氵 林
涯	氵 厂 圭
淹	氵 奄
渠	氵 巨 木
渐	氵 斩
淑	氵 叔
淌	氵 尚
混	氵 昆
淮	氵 隹
淆	氵 乂 有
渊	氵 ND 米
淫	氵 爪 壬
渔	氵 鱼
淘	氵 勹 缶
淳	氵 享
液	氵 夜
淤	氵 於
淡	氵 炎
淀	氵 定
深	氵 ⺳ 木
涮	氵 刷
涵	氵 函
婆	波 女
梁	氵 刀 八 木
渗	氵 参
情	忄 青
惜	忄 昔
惭	忄 斩
悼	忄 卓
惧	忄 具
惕	忄 易
惟	忄 隹
惊	忄 京
惦	忄 店
悴	忄 卒
惋	忄 宛
惨	忄 参
惯	忄 贯
寇	宀 元 攴
寅	宀 一 由 八
寄	宀 奇
寂	宀 叔
宿	宀 亻 百
窒	穴 至
窑	穴 缶
密	宀 必 山
谋	讠 某
谍	讠 世 木
谎	讠 荒
谐	讠 皆
袱	衤 伏
祷	礻 寿
祸	礻 呙
谓	讠 胃
谚	讠 彦
谜	讠 迷
逮	辶 隶
敢	乛 耳 攵
尉	尸 示 寸
屠	尸 者
弹	弓 单
隋	阝 左 月
堕	阝 有 土
随	阝 辶 有
蛋	疋 虫
隅	阝 禺
隆	阝 夂 一 生
隐	阝 急
婚	女 昏
婶	女 审
婉	女 宛
颇	皮 页
颈	XS 工 页
绩	纟 责
绪	纟 者
续	纟 卖
骑	马 奇
绰	纟 卓
绳	纟 黾
维	纟 隹
绵	纟 帛
绷	纟 朋
绸	纟 周
综	纟 宗
绽	纟 定
绿	纟 录
缀	纟 叕
巢	巛 果
琴	王 王 今
琳	王 林
琢	王 豕 丶
琼	王 京
斑	王 文 王
替	夫 夫 日
揍	扌 奏
款	士 示 欠
堪	土 甚
塔	土 艹 合
搭	扌 艹 合
堰	土 匚 日 女
揩	扌 皆
越	走 戈 Z
趁	走 人 彡
趋	走 刍
超	走 召
揽	扌 览
堤	土 是
提	扌 是
博	十 甫 寸
揭	扌 曷
喜	吉 UA J
彭	吉 UA 彡
揣	扌 耑
插	扌 千 臼
揪	扌 秋
搜	扌 叟
煮	者 灬
援	扌 爰
搀	扌 免 TD
裁	𢦏 衣
搁	扌 阁
搓	扌 差
搂	扌 娄
搅	扌 觉
壹	士 冖 豆
握	扌 屋
搔	扌 蚤
揉	扌 柔
斯	其 斤
期	其 月
欺	其 欠
联	耳 关
葫	艹 胡
散	廿 月 攵
惹	若 心
葬	艹 死 廾
募	莫 力
葛	艹 曷
董	艹 重
葡	艹 匍
敬	苟 攵
葱	艹 匆 心
蒋	艹 将
蒂	艹 帝
落	艹 洛
韩	龺 韦
朝	龺 月
辜	古 辛
葵	艹 癸
棒	木 奉
棱	木 土 八 夂
棋	木 其
椰	木 耶
植	木 直
森	木 林
焚	林 火
椅	木 奇
椒	木 叔
棵	木 果
棍	木 昆
椎	木 隹
棉	木 帛
棚	木 朋
棕	木 宗
棺	木 官
榔	木 郎
椭	木 阝 有
惠	FK 心
惑	或 心
逼	辶 一 口 田
粟	西 米
棘	木 冂 木 冂
酣	酉 甘
酥	酉 禾
厨	厂 豆 寸
厦	厂 夏
硬	石 更
硝	石 肖
确	石 角
硫	石 亠 厶 川
雁	厂 亻 隹
殖	歹 直
裂	列 衣
雄	𠂇 厶 隹
颊	夹 页
雳	雨 历
暂	斩 日
雅	牙 隹
翘	尧 羽
辈	非 车
悲	非 心
紫	此 糸
凿	业 半 凵
辉	光 军
敞	尚 攵
棠	龸 口 木
赏	龸 口 贝
掌	龸 口 手
晴	日 青
睐	目 来
暑	日 者
最	日 耳 又
晰	日 析
量	日 一 里
鼎	目 爿 片
喷	口 贲
喳	口 查
晶	日 日 日
喇	口 剌
遇	辶 禺
喊	口 咸
遏	辶 曷
晾	日 京
景	日 京
畴	田 寿
践	足 戈
跋	足 友 丶
跌	足 失
跑	足 包
跛	足 皮
遗	辶 贵
蛙	虫 圭
蛛	虫 朱
蜓	虫 廷
蜒	虫 延
蛤	虫 合
喝	口 曷
鹃	口 月 鸟
喂	口 畏
喘	口 耑
喉	口 侯
喻	口 俞
啼	口 帝
喧	口 宣
嵌	山 甘 欠
幅	巾 一 口 田
帽	巾 冒
赋	贝 武
赌	贝 者
赎	贝 卖
赐	贝 易
赔	贝 立 口
黑	四 土 灬
铸	钅 寿
铺	钅 甫
链	钅 连
销	钅 肖
锁	钅 小 贝
锄	钅 助
锅	钅 呙
锈	钅 秀
锋	钅 夂 丰
锌	钅 辛
锐	钅 兑
甥	生 男
掰	手 分 手
短	矢 豆
智	知 日
氮	气 炎
毯	毛 炎
氯	气 录
鹅	我 鸟
剩	乘 刂
稍	禾 肖
程	禾 呈
稀	禾 希
税	禾 兑
筐	⺮ 匡
等	⺮ 寺
筑	⺮ 巩
策	⺮ 木 冂
筛	⺮ 师
筒	⺮ 同
筏	⺮ 伐
答	⺮ 合
筋	⺮ 肋
筝	⺮ 争
傲	亻 敖
傅	亻 甫 寸
牌	片 卑
堡	保 土
集	隹 木
焦	隹 灬
傍	亻 旁
储	亻 诸
皓	白 告
皖	白 完
粤	NJ 米 一 Z
奥	NL 米 大
街	行 圭
惩	征 心
御	彳 卸
循	彳 盾
艇	舟 廷
舒	舍 予
逾	辶 俞
番	釆 田
释	釆 又 BI
禽	人 离
腊	月 昔
脾	月 卑
腋	月 夜
腔	月 空
腕	月 宛
鲁	鱼 日
猩	犭 星
猬	犭 胃
猾	犭 骨
猴	犭 侯
惫	备 心
然	RS 犬 灬
馈	饣 贵
馋	饣 免 TD
装	壮 衣
蛮	SK 虫
就	京 尤
敦	享 攵
斌	文 武
痘	疒 豆
痢	疒 利
痪	疒 奂
痛	疒 甬
童	立 里
竣	立 厶 八 夂
阔	门 活
善	羊 UA 口
翔	羊 羽
羡	羊 次
普	UA 业 日
粪	米 共
尊	酋 寸
奠	酋 大
道	辶 首
遂	辶 丷 豕
曾	丷 四 日
焰	火 ⺈ 臼
港	氵 巷
滞	氵 带
湖	氵 胡
湘	氵 相
渣	氵 查
渤	氵 勃
渺	氵 目 少
湿	氵 显
温	氵 日 皿
渴	氵 曷
溃	氵 贵
溅	氵 贱
滑	氵 骨
湃	氵 拜
渝	氵 俞
湾	氵 弯
渡	氵 度
游	氵 方 𠂉 子
滋	氵 兹
渲	氵 宣
溉	氵 既
愤	忄 贲
慌	忄 荒
惰	忄 左 月
愕	忄 口 口 亏
愣	忄 四 方
惶	忄 皇
愧	忄 鬼
愉	忄 俞
慨	忄 既
割	害 刂
寒	宀 甘 八 TD
富	宀 一 口 田
寓	宀 禺
窜	穴 串
窝	穴 呙
窖	穴 告
窗	穴 NJ 夕
窘	穴 君
遍	辶 扁
雇	户 隹
裕	衤 谷
裤	衤 库
裙	衤 君
禅	礻 单
禄	礻 录
谢	讠 射
谣	讠 爪 缶
谤	讠 旁
谦	讠 兼
犀	尸 水 牛
属	尸 禹
屡	尸 娄
强	弓 虽
粥	弓 米 弓
疏	⺪ 亠 厶 川
隔	阝 鬲
隙	阝 小 日 小
隘	阝 益
媒	女 某
絮	如 糸
嫂	女 叟
媚	女 眉
婿	女 胥
登	癶 豆
缅	纟 面
缆	纟 览
缉	纟 口 耳
缎	纟 段
缓	纟 爰
缔	纟 帝
缕	纟 娄
骗	马 扁
编	纟 扁
骚	马 蚤
缘	纟 彖
瑟	王 王 必
鹉	武 鸟
瑞	王 耑
瑰	王 鬼
瑙	王 巛 囟
魂	云 鬼
肆	CH 聿
摄	扌 聂
摸	扌 莫
填	土 真
搏	扌 甫 寸
塌	土 日 羽
鼓	士 口 UA 支
摆	扌 罢
携	扌 隽
搬	扌 般
摇	扌 爪 缶
搞	扌 高
塘	土 唐
摊	扌 难
聘	耳 由 一 Z
斟	甚 斗
蒜	艹 示 示
勤	堇 力
靴	革 化
靶	革 巴
鹊	昔 鸟
蓝	艹 监
墓	莫 土
幕	莫 巾
蓬	艹 逢
蓄	艹 畜
蒲	艹 浦
蓉	艹 容
蒙	艹 冖 一 豕
蒸	艹 丞 灬
献	南 犬
椿	木 春
禁	林 示
楚	林 疋
楷	木 皆
榄	木 览
想	相 心
槐	木 鬼
榆	木 俞
楼	木 娄
概	木 既
赖	束 负
酪	酉 各
酬	酉 州
感	咸 心
碍	石 日 一 寸
碘	石 典
碑	石 卑
碎	石 卒
碰	石 UA 业
碗	石 宛
碌	石 录
尴	尤 监
雷	雨 田
零	雨 令
雾	雨 务
雹	雨 包
辐	车 一 口 田
辑	车 口 耳
输	车 俞
督	叔 目
频	步 页
龄	齿 令
鉴	刂 M 金
睛	目 青
睹	目 者
睦	目 土 八 土
瞄	目 苗
睫	目 一 彐 止
睡	目 垂
睬	目 采
嗜	口 耆
鄙	口 十 回 阝
嗦	口 索
愚	禺 心
暖	日 爰
盟	明 皿
歇	曷 欠
暗	日 音
暇	日 叚
照	昭 灬
畸	田 奇
跨	足 夸
跷	足 尧
跳	足 兆
跺	足 朵
跪	足 危
路	足 各
跤	足 交
跟	足 艮
遣	辶 中 一 Y
蜈	虫 吴
蜗	虫 呙
蛾	虫 我
蜂	虫 夂 丰
蜕	虫 兑
嗅	口 臭
嗡	口 翁
嗓	口 桑
署	四 者
置	四 直
罪	四 非
罩	四 卓
蜀	四 勹 虫
幌	巾 晃
错	钅 昔
锚	钅 苗
锡	钅 易
锣	钅 罗
锤	钅 垂
锥	钅 隹
锦	钅 帛
键	钅 建
锯	钅 居
锰	钅 孟
矮	矢 委
辞	舌 辛
稚	禾 隹
稠	禾 周
颓	秃 页
愁	秋 心
筹	⺮ 寿
签	⺮ 佥
简	⺮ 间
筷	⺮ 快
毁	臼 工 殳
舅	臼 男
鼠	臼 ZD
催	亻 崔
傻	亻 囟 八 夂
像	亻 象
躲	身 朵
魁	鬼 斗
衙	行 吾
微	彳 山 一 几 攵
愈	俞 心
遥	辶 爪 缶
腻	月 贰
腰	月 要
腥	月 星
腮	月 思
腹	月 复
腺	月 泉
鹏	朋 鸟
腾	月 龹 马
腿	月 退
鲍	鱼 包
猿	犭 袁
颖	匕 禾 页
触	角 虫
解	角 刀 牛
煞	刍 攵 灬
雏	刍 隹
馍	饣 莫
馏	饣 留
酱	丬 夕 酉
禀	亠 回 示
痹	疒 畀
廓	广 郭
痴	疒 知
痰	疒 炎
廉	广 兼
靖	立 青
新	亲 斤
韵	音 匀
意	音 心
誊	龹 言
粮	米 良
数	娄 攵
煎	前 灬
塑	朔 土
慈	兹 心
煤	火 某
煌	火 皇
满	氵 𬜯
漠	氵 莫
滇	氵 真
源	氵 原
滤	氵 虑
滥	氵 监
滔	氵 舀
溪	氵 奚
溜	氵 留
漓	氵 离
滚	氵 衮
溢	氵 益
溯	氵 朔
滨	氵 宾
溶	氵 容
溺	氵 弱
粱	氵 刀 八 米
滩	氵 难
慎	忄 真
誉	兴 言
塞	宀 甘 八 土
寞	宀 莫
窥	穴 规
窟	穴 屈
寝	宀 丬 彐 冖 又
谨	讠 堇
褂	衤 卦
裸	衤 果
福	礻 一 口 田
谬	讠 羽 人 彡
群	君 羊
殿	尸 共 殳
辟	尸 口 辛
障	阝 章
媳	女 息
嫉	女 疾
嫌	女 兼
嫁	女 家
叠	又 双 冖 且
缚	纟 甫 寸
缝	纟 逢
缠	纟 广 里
缤	纟 宾
剿	巢 刂
静	青 争
碧	王 白 石
璃	王 离
赘	敖 贝
熬	敖 灬
墙	土 啬
墟	土 虚
嘉	吉 UA 加
摧	扌 崔
赫	赤 赤
截	𢦏 隹
誓	折 言
境	土 竟
摘	扌 亠 丷 LD
摔	扌 率
撇	扌 敝
聚	取 乑
慕	莫 ⺗
暮	莫 日
摹	莫 手
蔓	艹 曼
蔑	艹 四 戍
蔡	艹 祭
蔗	艹 庶
蔽	艹 敝
蔼	艹 谒
熙	H 巳 灬
蔚	艹 尉
兢	克 克
模	木 莫
槛	木 监
榴	木 留
榜	木 旁
榨	木 窄
榕	木 容
歌	哥 欠
遭	辶 曹
酵	酉 孝
酷	酉 告
酿	酉 良
酸	酉 厶 八 夂
碟	石 世 木
碱	石 咸
碳	石 炭
磁	石 兹
愿	原 心
需	雨 而
辖	车 害
辗	车 展
雌	此 隹
裳	龸 口 衣
颗	果 页
瞅	目 秋
墅	野 土
嗽	口 束 欠
踊	足 甬
蜻	虫 青
蜡	虫 昔
蝇	虫 黾
蜘	虫 知
蝉	虫 单
嘛	口 麻
嘀	口 亠 丷 LD
赚	贝 兼
锹	钅 秋
锻	钅 段
镀	钅 度
舞	𠂉 EA 舛
舔	舌 忝
稳	禾 急
熏	千 四 二 灬
箕	⺮ 其
算	⺮ 目 廾
箩	⺮ 罗
管	⺮ 官
箫	⺮ 肃
舆	臼 车 八
僚	亻 大 丷 日 小
僧	亻 曾
鼻	自 畀
魄	白 鬼
魅	鬼 未
貌	豸 白 儿
膜	月 莫
膊	月 甫 寸
膀	月 旁
鲜	鱼 羊
疑	匕 矢 龴 疋
孵	卵 孚
馒	饣 曼
裹	亠 果 氏
敲	高 攴
豪	亠 口 冖 豕
膏	亠 口 冖 口 月
遮	辶 庶
腐	广 付 肉
瘩	疒 艹 合
瘟	疒 日 皿
瘦	疒 叟
辣	辛 束
彰	章 彡
竭	立 曷
端	立 耑
旗	方 𠂉 其
精	米 青
粹	米 卒
歉	兼 欠
弊	敝 廾
熄	火 息
熔	火 容
煽	火 扇
潇	氵 萧
漆	氵 木 八 水
漱	氵 束 欠
漂	氵 票
漫	氵 曼
滴	氵 亠 丷 LD
漾	氵 羊 永
演	氵 寅
漏	氵 尸 雨
慢	忄 曼
慷	忄 康
寨	宀 甘 八 木
赛	宀 甘 八 贝
寡	宀 一 自 八 刀	# “自”可能有误，不影响编码
察	宀 祭
蜜	宀 必 虫
寥	宀 羽 人 彡
谭	讠 覃
肇	户 攵 聿
褐	衤 曷
褪	衤 退
谱	讠 普
隧	阝 遂
嫩	女 敕
翠	羽 卒
熊	能 灬
凳	登 几
骡	马 累
缩	纟 宿
慧	丰 丰 彐 心
撵	扌 夫 夫 车
撕	扌 斯
撒	扌 散
撩	扌 大 丷 日 小
趣	走 取
趟	走 尚
撑	扌 掌
撮	扌 最
撬	扌 毛 毛 毛
播	扌 番
擒	扌 禽
墩	土 敦
撞	扌 童
撤	扌 育 攵
增	土 曾
撰	扌 巽
聪	耳 总
鞋	革 圭
鞍	革 安
蕉	艹 焦
蕊	艹 心 心 心
蔬	艹 疏
蕴	艹 纟 日 皿
横	木 黄
槽	木 曹
樱	木 婴
橡	木 象
樟	木 章
橄	木 敢
敷	甫 方 攵
豌	豆 宛
飘	票 风
醋	酉 昔
醇	酉 享
醉	酉 卒
磕	石 去 皿
磊	石 石 石
磅	石 旁
碾	石 展
震	雨 辰
霄	雨 肖
霉	雨 每
瞒	目 𬜯
题	是 页
暴	日 共 水
瞎	目 害
嘻	口 喜
嘶	口 斯
嘲	口 朝
嘹	口 大 丷 日 小
影	景 彡
踢	足 易
踏	足 沓
踩	足 采
踪	足 宗
蝶	虫 世 木
蝴	虫 胡
蝠	虫 一 口 田
蝎	虫 曷
蝌	虫 科
蝗	虫 皇
蝙	虫 扁
嘿	口 黑
嘱	口 属
幢	巾 童
墨	黑 土
镇	钅 真
镐	钅 高
镑	钅 旁
靠	告 非
稽	禾 尤 旨
稻	禾 爪 臼
黎	禾 勹 丿 人 水
稿	禾 高
稼	禾 家
箱	⺮ 相
篓	⺮ 娄
箭	⺮ 前
篇	⺮ 扁
僵	亻 三 田 田
躺	身 尚
僻	亻 辟
德	彳 十 四 一 心
艘	舟 叟
膝	月 木 八 水
膛	月 堂
鲤	鱼 里
鲫	鱼 即
熟	享 丸 灬
摩	广 林 手
褒	亠 保 氏
瘪	疒 自 人 匕
瘤	疒 留
瘫	疒 难
凛	冫 禀
颜	彦 页
毅	立 豕 殳
糊	米 胡
遵	辶 尊
憋	敝 心
潜	氵 替
澎	氵 彭
潮	氵 朝
潭	氵 西 早
鲨	沙 鱼
澳	氵 奥
潘	氵 番
澈	氵 育 攵
澜	氵 门 柬
澄	氵 登
懂	忄 董
憔	忄 焦
懊	忄 奥
憎	忄 曾
额	客 页
翩	扁 羽
褥	衤 辱
谴	讠 遣
鹤	隺 鸟
憨	敢 心
慰	尉 心
劈	辟 刀
履	尸 彳 复
豫	予 象
缭	纟 大 丷 日 小
撼	扌 感
擂	扌 雷
操	扌 品 木
擅	扌 亶
燕	廿 丬 口 匕 灬	# 不合笔顺
蕾	艹 雷
薯	艹 署
薛	艹 丿 Y 辛
薇	艹 微
擎	敬 手
薪	艹 新
薄	艹 溥
颠	真 页
翰	龺 人 羽
噩	王 口 口 口 口
橱	木 厨
橙	木 登
橘	木 矞
整	敕 正
融	鬲 虫
瓢	票 瓜
醒	酉 星
霍	雨 隹
霎	雨 妾
辙	车 育 攵
冀	北 田 共
餐	卜 夕 又 食
嘴	口 此 角
踱	足 度
蹄	足 帝
蹂	足 柔
蟆	虫 莫
螃	虫 旁
器	口 口 犬 口 口
噪	口 品 木
鹦	婴 鸟
赠	贝 曾
默	黑 犬
黔	黑 今
镜	钅 竟
赞	先 先 贝
穆	禾 白 小 彡
篮	⺮ 监
篡	⺮ 目 大 厶
篷	⺮ 逢
篱	⺮ 离
儒	亻 需
邀	辶 敫
衡	行 鱼 大
膨	月 彭
雕	周 隹
鲸	鱼 京
磨	广 林 石
瘾	疒 隐
瘸	疒 加 肉
凝	冫 疑
辨	辛 UD 辛
辩	辛 讠 辛
糙	米 造
糖	米 唐
糕	米 羔
燃	火 然
濒	氵 频
澡	氵 品 木
激	氵 敫
懒	忄 赖
憾	忄 感
懈	忄 解
窿	穴 隆
壁	辟 土
避	辶 辟
缰	纟 三 田 田
缴	纟 敫
戴	𢦏 田 共
擦	扌 察
藉	艹 耒 昔
鞠	革 勹 米
藏	艹 臧
藐	艹 貌
檬	木 蒙
檐	木 詹
檀	木 亶
礁	石 焦
磷	石 米 舛
霜	雨 相
霞	雨 叚
瞭	目 大 丷 日 小
瞧	目 焦
瞬	目 爪 冖 舛
瞳	目 童
瞩	目 属
瞪	目 登
曙	日 署
蹋	足 日 羽
蹈	足 舀
螺	虫 累
蟋	虫 悉
蟀	虫 率
嚎	口 豪
赡	贝 詹
穗	禾 FK 心
魏	委 鬼
簧	⺮ 黄
簇	⺮ 族
繁	敏 糸
徽	彳 山 一 糸 攵
爵	爪 四 艮 寸
朦	月 蒙
臊	月 品 木
鳄	鱼 口 口 亏
癌	疒 品 山
辫	辛 纟 辛
赢	亡 口 月 贝 凡
糟	米 曹
糠	米 康
燥	火 品 木
懦	忄 需
豁	害 谷
臀	殿 月
臂	辟 月
翼	羽 田 共
骤	马 聚
藕	艹 耦
鞭	革 便
藤	艹 滕
覆	西 彳 复
瞻	目 詹
蹦	足 崩
嚣	口 口 页 口 口
镰	钅 廉
翻	番 羽
鳍	鱼 耆
鹰	广 亻 隹 鸟
瀑	氵 暴
襟	衤 禁
璧	辟 玉
戳	翟 戈
孽	薛 子
警	敬 言
蘑	艹 磨
藻	艹 澡
攀	木 乂 乂 木 大 手
曝	日 暴
蹲	足 尊
蹭	足 曾
蹬	足 登
巅	山 颠
簸	⺮ 其 皮
簿	⺮ 氵 甫 寸
蟹	解 虫
颤	亶 页
靡	广 林 非
癣	疒 鲜
瓣	辛 瓜 辛
羹	羔 美
鳖	敝 鱼
爆	火 暴
疆	弓 土 三 田 田
鬓	髟 宾
壤	土 襄
馨	声 殳 香
耀	光 翟
躁	足 品 木
蠕	虫 需
嚼	口 爵
嚷	口 襄
巍	山 魏
籍	⺮ 耒 昔
鳞	鱼 米 舛
魔	广 林 鬼
糯	米 需
灌	氵 艹 口 口 隹
譬	辟 言
蠢	春 虫 虫
霸	雨 革 月
露	雨 足 各
霹	雨 辟
躏	足 蔺
黯	黑 音
髓	骨 辶 左 月
赣	章 夂 贡
囊	一 中 冖 口 口 甘 氏
镶	钅 襄
瓤	襄 瓜
罐	缶 艹 口 口 隹
矗	直 直 直
