# -*- encoding: utf8 -*-
# 二级字 (3000)
乂	OS
乜	𠃌 Z
兀	GR
弋	HS
孑	YA	# 或 Y A？
孓	了 丶
幺	Z 厶
亓	二 ND
韦	BI 𠃌
廿	EA
丏	丁 Z 𠃌
卅	一 川
仄	厂 人
厄	厂 ⺋
仃	亻 丁
仉	亻 几
仂	亻 力
兮	八 一 Z
刈	乂 刂
爻	乂 乂
卞	亠 卜
闩	门 一
讣	讠 卜
尹	XMA
夬	乛 大
爿	ZI
毋	ZY 丿 一	# 笔顺：先撇后横
邗	干 阝
邛	工 阝
艽	艹 九
艿	艹 乃
札	木 乚
叵	匚 口
匝	匚 巾
丕	不 一
匜	匚 也
劢	万 力
卟	口 卜
叱	口 匕
叻	口 力
仨	亻 三
仕	亻 士
仟	亻 千
仡	亻 乞
仫	亻 么
仞	亻 刃
卮	⺁ 一 ⺋
氐	氏 丶
犰	犭 九
刍	⺈ 彐
邝	广 阝
邙	亡 阝
汀	氵 丁
讦	讠 干
讧	讠 工
讪	讠 山
讫	讠 乞
尻	尸 九
阡	阝 千
尕	乃 小
弁	厶 廾
驭	马 又
匡	匚 王
耒	CK
玎	王 丁
玑	王 几
邢	开 阝
圩	土 于
圬	土 亏
圭	土 土
扦	扌 千
圪	土 乞
圳	土 川
圹	土 广
扪	扌 门
圮	土 己
圯	土 巳
芊	艹 千
芍	艹 勺
芄	艹 丸
芨	艹 及
芑	艹 己
芎	艹 弓
芗	艹 乡
亘	二 日
厍	厂 车
夼	大 川
戍	戊 丶
尥	尤 勺
乩	占 乚
旯	日 九
曳	日 Z 丿
岌	山 及
屺	山 己
凼	水 凵
囡	囗 女
钇	钅 乙
缶	午 凵
氘	气 ND
氖	气 乃
牝	牛 匕
伎	亻 支
伛	亻 区
伢	亻 牙
佤	亻 瓦
仵	亻 午
伥	亻 长
伧	亻 仓
伉	亻 亢
伫	亻 宀 一
囟	NJ 乂
汆	入 水
刖	月 刂
夙	几 歹
旮	九 日
刎	勿 刂
犷	犭 广
犸	犭 马
舛	夕 牛
凫	鸟 几
邬	乌 阝
饧	饣 Y OD
汕	氵 山
汔	氵 乞
汐	氵 夕
汲	氵 及
汜	氵 巳
汊	氵 叉
忖	忄 寸
忏	忄 千
讴	讠 区
讵	讠 巨
祁	礻 阝
讷	讠 内
聿	肀 二
艮	XO
厾	⺄ 去
阱	阝 井
阮	阝 元
阪	阝 反
丞	乛 水 一
妁	女 勺
牟	厶 牛
纡	纟 于
纣	纟 寸
纥	纟 乞
纨	纟 丸
玕	王 干
玙	王 与
抟	扌 专
抔	扌 不
圻	土 斤
坂	土 反
坍	土 丹
坞	土 乌
抃	扌 卞
抉	扌 夬
㧐	扌 双
芫	艹 元
邯	甘 阝
芸	艹 云
芾	艹 一 巾
苈	艹 历
苣	艹 巨
芷	艹 止
芮	艹 内
苋	艹 见
芼	艹 毛
苌	艹 长
苁	艹 从
芩	艹 今
芪	艹 氏
芡	艹 欠
芟	艹 殳
苄	艹 卞
苎	艹 宀 一
苡	艹 以
杌	木 兀
杓	木 勺
杞	木 己
杈	木 叉
忑	下 心
孛	十 冖 子
邴	丙 阝
邳	丕 阝
矶	石 几
奁	大 区
豕	GQ
忒	弋 心
欤	与 欠
轫	车 刃
迓	辶 牙
邶	北 阝
忐	上 心
卣	卜 囗 X
邺	业 阝
旰	日 干
呋	口 夫
呒	口 无
呓	口 艺
呔	口 太
呖	口 历
呃	口 厄
旸	日 Y OD
吡	口 比
町	田 丁
虬	虫 乚
呗	口 贝
吽	口 牛
吣	口 心
吲	口 引
帏	巾 韦
岐	山 支
岈	山 牙
岘	山 见
岑	山 今
岚	山 风
兕	凹 儿
囵	囗 仑
囫	囗 勿
钊	钅 刂
钋	钅 卜
钌	钅 了
迕	辶 午
氙	气 山
氚	气 川
牤	牛 亡
佞	亻 二 女
邱	丘 阝
攸	亻 丨 攵
佚	亻 失
佝	亻 句
佟	亻 冬
佗	亻 它
伽	亻 加
彷	彳 方
佘	人 示
佥	人 二 VD
孚	爪 子
豸	PQ
坌	分 土
肟	月 亏
邸	氐 阝
奂	⺈ 冂 大
劬	句 力
狄	犭 火
狁	犭 允
鸠	九 鸟
邹	刍 阝
饨	饣 屯
饩	饣 气
饪	饣 壬
饫	饣 夭
饬	饣 𠂉 力
亨	亠 口 了
庑	广 无
庋	广 支
疔	疒 丁
疖	疒 Y
肓	亡 月
闱	门 韦
闳	门 𠂇 厶
闵	门 文
羌	羊 乚	#** “羊儿”误
炀	火 Y OD
沣	氵 丰
沅	氵 元
沔	氵 丏
沤	氵 区
沌	氵 屯
沏	氵 切
沚	氵 止
汩	氵 曰
汨	氵 日
沂	氵 斤
汾	氵 分
沨	氵 风
汴	氵 卞
汶	氵 文
沆	氵 亢
沩	氵 为
泐	氵 阝 力
怃	忄 无
怄	忄 区
忡	忄 中
忤	忄 午
忾	忄 气
怅	忄 长
忻	忄 斤
忪	忄 公
怆	忄 仓
忭	忄 卞
忸	忄 丑
诂	讠 古
诃	讠 可
诅	讠 且
诋	讠 氐
诌	讠 刍
诏	讠 召
诒	讠 台
孜	子 攵
陇	阝 龙
陀	阝 它
陂	阝 皮
陉	阝 XS 工
妍	女 开
妩	女 无
妪	女 区
妣	女 比
妊	女 壬
妗	女 今
妫	女 为
妞	女 丑
姒	女 以
妤	女 予
邵	召 阝
劭	召 力
刭	XS 工 刂
甬	龴 LD
邰	台 阝
纭	纟 云
纰	纟 比
纴	纟 壬
纶	纟 仑
纾	纟 予
玮	王 韦
玡	王 牙
玭	王 比
玠	王 介
玢	王 分
玥	王 月
玦	王 夬
盂	于 皿
忝	天 ⺗
匦	匚 轨
坩	土 甘
抨	扌 平
拤	扌 卡
坫	土 占
拈	扌 占
垆	土 卢
抻	扌 申
劼	吉 力
拃	扌 乍
拊	扌 付
坼	土 斥
坻	土 氐
㧟	扌 汇
坨	土 它
坭	土 尼
抿	扌 民
坳	土 幼
耶	耳 阝
苷	艹 甘
苯	艹 本
苤	艹 丕
茏	艹 龙
苫	艹 占
苜	艹 目
苴	艹 且
苒	艹 冉
苘	艹 LD
茌	艹 仕
苻	艹 付
苓	艹 令
茚	艹 印
茆	艹 卯
茑	艹 鸟
茓	艹 穴
茔	艹 冖 土
茕	艹 冖 ⺄ 十
茀	艹 弗
苕	艹 召
枥	木 历
枇	木 比
杪	木 少
杳	木 日
枧	木 见
杵	木 午
枨	木 长
枞	木 从
枋	木 方
杻	木 丑
杷	木 巴
杼	木 予
矸	石 干
砀	石 Y OD
刳	夸 刂
奄	大 电
瓯	区 瓦
殁	歹 殳
郏	夹 阝
轭	车 厄
郅	至 阝
鸢	弋 鸟
盱	目 于
昊	日 天
昙	日 云
杲	日 木
昃	日 仄
咂	口 匝
呸	口 丕
昕	日 斤
昀	日 匀
旻	日 文
昉	日 方
炅	日 火
咔	口 卡
畀	田 丌
虮	虫 几
咀	口 且
呷	口 甲
黾	口 电
呱	口 瓜
呤	口 令
咚	口 冬
咆	口 包
咛	口 宁
呶	口 奴
呣	口 母
呦	口 幼
咝	口 丝
岢	山 可
岿	山 归
岬	山 甲
岫	山 由
帙	巾 失
岣	山 句
峁	山 卯
刿	岁 刂
迥	辶 LD
岷	山 民
剀	岂 刂
帔	巾 皮
峄	山 又 BI
沓	水 日
囹	囗 令
罔	冂 UA 亡
钍	钅 土
钎	钅 千
钏	钅 川
钒	钅 凡
钕	钅 女
钗	钅 叉
邾	朱 阝
迮	辶 乍
牦	牛 毛
竺	⺮ 二
迤	辶 𠂉 也
佶	亻 吉
佬	亻 老
佰	亻 百
侑	亻 有
侉	亻 夸
臾	臼 人
岱	代 山
侗	亻 同
侃	亻 口 川
侏	亻 朱
侩	亻 会
佻	亻 兆
佾	亻 八 月
侪	亻 齐
佼	亻 交
佯	亻 羊
侬	亻 农
帛	白 巾
阜	丿 Y 十
侔	亻 牟
徂	彳 且
刽	会 刂
郄	乂 𠂇 厶 阝
怂	从 心
籴	入 米
瓮	公 瓦
戗	仓 戈
肼	月 井
䏝	月 专
肽	月 太
肱	月 𠂇 厶
肫	月 屯
剁	朵 刂
迩	辶 尔
郇	旬 阝
狙	犭 且
狎	犭 甲
狍	犭 包
狒	犭 弗
咎	处 口
炙	RS 火
枭	鸟 木
饯	饣 戈
饴	饣 台
冽	冫 列
冼	冫 先
庖	广 包
疠	疒 万
疝	疒 山
疡	疒 Y OD
兖	六 允
妾	立 女
劾	亥 力
炜	火 韦
𬉼	火 区
炖	火 屯
炘	火 斤
炝	火 仓
炔	火 夬
泔	氵 甘
沭	氵 术
泷	氵 龙
泸	氵 卢
泱	氵 央
泅	氵 囚
泗	氵 四
泠	氵 令
泺	氵 乐
泖	氵 卯
泫	氵 玄
泮	氵 半
沱	氵 它
泯	氵 民
泓	氵 弘
泾	氵 XS 工
怙	忄 古
怵	忄 术
怦	忄 平
怛	忄 旦
怏	忄 央
怍	忄 乍
㤘	忄 刍
怩	忄 尼
怫	忄 弗
怿	忄 又 BI
宕	宀 石
穹	穴 弓
宓	宀 必
诓	讠 匡
诔	讠 耒
诖	讠 圭
诘	讠 吉
戾	户 犬
诙	讠 灰
戽	户 斗
郓	军 阝
衩	衤 叉
祆	礻 天
祎	礻 韦
祉	礻 止
祇	礻 氏
诛	讠 朱
诜	讠 先
诟	讠 后
诠	讠 全
诣	讠 旨
诤	讠 争
诧	讠 宅
诨	讠 军
诩	讠 羽
戕	爿 戈	
孢	子 包
亟	了 口 又 一
陔	阝 亥
妲	女 旦
妯	女 由
姗	女 册
帑	奴 巾
弩	奴 弓
孥	奴 子
驽	奴 马
虱	⺄ 丿 虫
迦	辶 加
迨	辶 台
绀	纟 甘
绁	纟 世
绂	纟 友 丶
驷	马 四
驸	马 付
绉	纟 刍
绌	纟 出
驿	马 又 BI
骀	马 台
甾	巛 田
珏	王 玉
珐	王 去
珂	王 可
珑	王 龙
玳	王 代
珀	王 白
顸	干 页
珉	王 民
珈	王 加
拮	扌 吉
垭	土 亚
挝	扌 过
垣	土 亘
挞	扌 达
垤	土 至
赳	走 丩
贲	十 艹 贝
垱	土 当
垌	土 同
郝	赤 阝
垧	土 向
垓	土 亥
挦	扌 寻
垠	土 艮
茜	艹 西
荚	艹 夹
荑	艹 夷
贳	世 贝
荜	艹 毕
莒	艹 吕
茼	艹 同
茴	艹 回
茱	艹 朱
莛	艹 廷
荞	艹 乔
茯	艹 伏
荏	艹 任
荇	艹 行
荃	艹 全
荟	艹 会
荀	艹 旬
茗	艹 名
荠	艹 齐
茭	艹 交
茨	艹 次
垩	亚 土
荥	艹 冖 水
荦	艹 冖 牛
荨	艹 寻
荩	艹 尽
剋	克 刂
荪	艹 孙
茹	艹 如
荬	艹 买
荮	艹 纣
柰	木 示
栉	木 节
柯	木 可
柘	木 石
栊	木 龙
柩	木 匚 久
枰	木 平
栌	木 卢
柙	木 甲
枵	木 号
柚	木 由
枳	木 只
柞	木 乍
柝	木 斥
栀	木 卮
柢	木 氐
栎	木 乐
枸	木 句
柈	木 半
柁	木 它
枷	木 加
柽	木 圣
剌	束 刂
酊	酉 丁
郦	丽 阝
甭	不 LD
砗	石 车
砘	石 屯
砒	石 比
斫	石 斤
砭	石 乏
砜	石 风
奎	大 圭
耷	大 耳
虺	兀 虫
殂	歹 且
殇	歹 𠂉 Y OD
殄	歹 人 彡
殆	歹 台
轱	车 古
轲	车 可
轳	车 卢
轶	车 失
轸	车 人 彡
虿	万 虫
毖	比 必
觇	占 见
尜	小 大 小
哐	口 匡
眄	目 丏
眍	目 区
𠳐	口 邦
郢	呈 阝
眇	目 少
眊	目 毛
眈	目 冖 儿
禺	日 冂 厶
哂	口 西
咴	口 灰
曷	日 RY
昴	日 卯
昱	日 立
昵	日 尼
咦	口 夷
哓	口 尧
哔	口 毕
畎	田 犬
毗	田 比
呲	口 此
胄	由 月
畋	田 攵
畈	田 反
虼	虫 乞
虻	虫 亡
盅	中 皿
咣	口 光
哕	口 岁
剐	呙 刂
郧	员 阝
咻	口 休
囿	囗 有
咿	口 伊
哌	口 ⺁ 氏
哙	口 会
哚	口 朵
咯	口 各
咩	口 羊
咤	口 宅
哝	口 农
哏	口 艮
哞	口 牟
峙	山 寺
峣	山 尧
罘	四 不
帧	巾 贞
峒	山 同
峤	山 乔
峋	山 旬
峥	山 争
贶	贝 兄
钚	钅 不
钛	钅 太
钡	钅 贝
钣	钅 反
钤	钅 今
钨	钅 乌
钫	钅 方
钯	钅 巴
氡	气 冬
氟	气 弗
牯	牛 古
郜	告 阝
秕	禾 比
秭	禾 丿 Z 丨 丿
竽	⺮ 于
笈	⺮ 及
笃	⺮ 马
俦	亻 寿
俨	亻 严
俅	亻 求
俪	亻 丽
叟	臼 又
垡	伐 土
牮	代 牛
俣	亻 吴
俚	亻 里
皈	白 反
俑	亻 甬
俟	亻 矣
逅	辶 后
徇	彳 旬
徉	彳 羊
舢	舟 山
俞	人 一 月 刂
郗	希 阝
俎	人 人 且
郤	谷 阝
爰	爪 一 友
郛	孚 阝
瓴	令 瓦
胨	月 东
胪	月 卢
胛	月 甲
胂	月 申
胙	月 乍
胍	月 瓜
胗	月 人 彡
胝	月 氐
朐	月 句
胫	月 XS 工
鸨	匕 十 鸟
匍	勹 甫
狨	犭 戎
狯	犭 会
飑	风 包
狩	犭 守
狲	犭 孙
訇	勹 言
逄	辶 夂 牛
昝	处 日
饷	饣 向
饸	饣 合
饹	饣 各
胤	儿 幺 月
孪	SK 子
娈	SK 女
弈	亦 廾
奕	亦 大
庥	广 休
疬	疒 历
疣	疒 尤
疥	疒 介
疭	疒 从
庠	广 羊
竑	立 𠂇 厶
彦	产 彡
飒	立 风
闼	门 达
闾	门 吕
闿	门 岂
阂	门 亥
羑	羊 久
迸	辶 并
籼	米 山
酋	丷 酉
炳	火 丙
炻	火 石
炽	火 只
炯	火 LD
烀	火 乎
炷	火 主
烃	火 XS 工
洱	氵 耳
洹	氵 亘
洧	氵 有
洌	氵 列
浃	氵 夹
洇	氵 因
洄	氵 回
洙	氵 朱
涎	氵 延
洎	氵 自
洫	氵 血
浍	氵 会
洮	氵 兆
洵	氵 旬
浒	氵 许
浔	氵 寻
浕	氵 尽
洳	氵 如
恸	忄 动
恓	忄 西
恹	忄 厌
恫	忄 同
恺	忄 岂
恻	忄 则
恂	忄 旬
恪	忄 各
恽	忄 军
宥	宀 有
扃	户 LD
衲	衤 内
衽	衤 壬
衿	衤 今
袂	衤 夬
祛	礻 去
祜	礻 古
祓	礻 友 丶
祚	礻 乍
诮	讠 肖
祗	礻 氐
祢	礻 尔
诰	讠 告
诳	讠 狂
鸩	冖 儿 鸟
昶	永 日
郡	君 阝
咫	尺 只
弭	弓 耳
牁	爿 可
胥	疋 月
陛	阝 比 土
陟	阝 步
娅	女 亚
姮	女 亘
娆	女 尧
姝	女 朱
姣	女 交
姘	女 并
姹	女 宅
怼	对 心
羿	羽 廾
炱	台 火
矜	矛 今
绔	纟 夸
骁	马 尧
骅	马 华
绗	纟 行
绛	纟 夂 牛
骈	马 并
耖	耒 少
挈	丰 刀 手
珥	王 耳
珙	王 共
顼	王 页
珰	王 当
珩	王 行
珧	王 兆
珣	王 旬
珞	王 各
琤	王 争
珲	王 军
敖	丰 力 攵
恚	圭 心
埔	土 甫
埕	土 呈	
埘	土 时	
埙	土 员	
埚	土 呙	
挹	扌 邑
耆	老 日
耄	老 毛
埒	土 爪 寸
捋	扌 爪 寸
贽	执 贝
垸	土 完
捃	扌 君
盍	去 皿
荸	艹 孛
莆	艹 甫
莳	艹 时
莴	艹 呙
莪	艹 我
莠	艹 秀
莓	艹 每
莜	艹 攸
莅	艹 位
荼	艹 余
莩	艹 孚
荽	艹 妥
莸	艹 犹
荻	艹 狄
莘	艹 辛
莎	艹 沙
莞	艹 完
莨	艹 良
鸪	古 鸟
莼	艹 纯
栲	木 考
栳	木 老
郴	林 阝
桓	木 亘
桡	木 尧
桎	木 至
桢	木 贞
桤	木 岂
梃	木 廷
栝	木 舌
桕	木 臼
桁	木 行
桧	木 会
桅	木 危
栟	木 并
桉	木 安
栩	木 羽
逑	辶 求
逋	辶 甫
彧	戈 口 一
鬲	一 口 LD
豇	豆 工
酐	酉 干
逦	辶 丽
厝	厂 昔
孬	不 好
砝	石 去
砹	石 艾
砺	石 厉
砧	石 占
砷	石 申
砟	石 乍
砼	石 仝
砥	石 氐
砣	石 它
剞	奇 刂
砻	龙 石
轼	车 式
轾	车 至
辂	车 各
鸫	东 鸟
趸	万 足
龀	齿 匕
鸬	卢 鸟
虔	虍 文
逍	辶 肖
眬	目 龙
唛	口 麦
晟	日 成
眩	目 玄
眙	目 台
哧	口 赤
哽	口 更
唔	口 五
晁	日 兆
晏	日 安
鸮	号 鸟
趵	足 勺
趿	足 及
畛	田 人 彡
蚨	虫 夫
蚜	虫 牙
蚍	虫 比
蚋	虫 内
蚬	虫 见
蚝	虫 毛
蚧	虫 介
唢	口 小 贝
圄	囗 吾
唣	口 皂
唏	口 希
盎	央 皿
唑	口 坐
崂	山 劳
崃	山 来
罡	四 正
罟	四 古
峪	山 谷
觊	岂 见
赅	贝 亥
钰	钅 玉
钲	钅 正
钴	钅 古
钵	钅 本
钹	钅 友 丶
钺	钅 戈 Z
钽	钅 旦
钼	钅 目
钿	钅 田
铀	钅 由
铂	钅 白
铄	钅 乐
铆	钅 卯
铈	钅 市
铉	钅 玄
铊	钅 它
铋	钅 必
铌	钅 尼
铍	钅 皮
䥽	钅 发
铎	钅 又 BI
氩	气 亚
氤	气 因
氦	气 亥
毪	毛 牟
舐	舌 氏
秣	禾 末
秫	禾 术
盉	禾 皿
笄	⺮ 开
笕	⺮ 见
笊	⺮ 爪
笏	⺮ 勿
笆	⺮ 巴
俸	亻 奉
倩	亻 青
俵	亻 表
偌	亻 若
俳	亻 非
俶	亻 叔
倬	亻 卓
倏	亻 丨 夂 犬
恁	任 心
倭	亻 委
倪	亻 臼 儿
俾	亻 卑
倜	亻 周
隼	隹 十
隽	隹 乃
倌	亻 官
倥	亻 空
臬	自 木
皋	白 大 十
郫	卑 阝
倨	亻 居
衄	血 丑
颀	斤 页
徕	彳 来
舫	舟 方
釜	父 王 丷
奚	爪 幺 大
衾	今 衣
胯	月 夸
胱	月 光
胴	月 同
胭	月 因
脍	月 会
胼	月 并
朕	月 关
脒	月 米
胺	月 安
鸱	氐 鸟
玺	尔 玉
鸲	句 鸟
狷	犭 口 月
猁	犭 利
狳	犭 余
猃	犭 佥
狺	犭 言
逖	辶 狄
桀	舛 木
袅	鸟 衣
饽	饣 孛
凇	冫 松
栾	SK 木
挛	SK 手
亳	亠 口 冖 乇
疳	疒 甘
疴	疒 可
疸	疒 旦
疽	疒 且
痈	疒 LD
疱	疒 包
痂	疒 加
痉	疒 XS 工
衮	亠 公 氏
凋	冫 周
颃	亢 页
恣	次 心
旆	方 𠂉 一 巾
旄	方 𠂉 毛
旃	方 𠂉 丹
阃	门 困
阄	门 龟
訚	门 言
阆	门 良
恙	羊 心
粑	米 巴
朔	UA 屮 月
郸	单 阝
烜	火 亘
烨	火 华
烩	火 会
烊	火 羊
剡	炎 刂
郯	炎 阝
烬	火 尽
涑	氵 束
浯	氵 吾
涞	氵 来
涟	氵 连
娑	沙 女
涅	氵 日 土
涠	氵 围
浞	氵 足
涓	氵 口 月
浥	氵 邑
涔	氵 岑
浜	氵 兵
浠	氵 希
浣	氵 完
浚	氵 厶 八 夂
悚	忄 束
悭	忄 坚
悝	忄 里
悒	忄 邑
悌	忄 弟
悛	忄 厶 八 夂
宸	宀 辰
窈	穴 幼
剜	宛 刂
诹	讠 取
冢	冖 豕 丶
诼	讠 豕 丶
袒	衤 旦
袢	衤 半
祯	礻 贞
诿	讠 委
谀	讠 臾
谂	讠 念
谄	讠 ⺈ 臼
谇	讠 卒
屐	尸 彳 支
屙	尸 阿
陬	阝 取
勐	孟 力
奘	爿 士 大
牂	爿 羊
蚩	屮 一 虫
陲	阝 垂
姬	女 臣
娠	女 辰
娌	女 里
娉	女 由 一 Z
娲	女 呙
娩	女 免
娴	女 闲
娣	女 弟
娓	女 尾
婀	女 阿
畚	厶 奋
逡	辶 厶 八 夂
绠	纟 更
骊	马 丽
绡	纟 肖
骋	马 由 一 Z
绥	纟 妥
绦	纟 条
绨	纟 弟
骎	马 彐 冖 又
邕	巛 邑
鸶	丝 鸟
彗	丰 丰 彐
耜	耒 Y
焘	寿 灬
舂	𡗗 臼
琏	王 连
琇	王 秀
麸	麦 夫
揶	扌 耶
埴	土 直
埯	土 奄
捯	扌 到
掳	扌 虏
掴	扌 国
埸	土 易
埵	土 垂
赧	赤 卩 又
埤	土 卑
捭	扌 卑
逵	辶 土 八 土
埝	土 念
堋	土 朋
堍	土 兔
掬	扌 勹 米
鸷	执 鸟
掖	扌 夜
捽	扌 卒
掊	扌 立 口
堉	土 育
掸	扌 单
捩	扌 戾
掮	扌 肩
悫	壳 心
埭	土 隶
埽	土 帚
掇	扌 叕
掼	扌 贯
聃	耳 冉
菁	艹 青
萁	艹 其
菘	艹 松
堇	廿 口 丰
萘	艹 奈
萋	艹 妻
菽	艹 叔
菖	艹 昌
萜	艹 帖
萸	艹 臾
萑	艹 隹
棻	芬 木
菔	艹 服
菟	艹 兔
萏	艹 ⺈ 臼
萃	艹 卒
菏	艹 河
菹	艹 沮
菪	艹 宕
菅	艹 官
菀	艹 宛
萦	艹 冖 糸
菰	艹 孤
菡	艹 函
梵	林 凡
梿	木 连
梏	木 告
觋	巫 见
桴	木 孚
桷	木 角
梓	木 辛
棁	木 兑
桫	木 沙
棂	木 灵
啬	十 UA 回
郾	匚 日 女 阝
匮	匚 贵
敕	束 攵
豉	豆 支
鄄	西 土 阝
酞	酉 太
酚	酉 分
戛	一 自 戈
硎	石 刑
硭	石 芒
硒	石 西
硖	石 夹
硗	石 尧
硐	石 同
硇	石 囟
硌	石 各
鸸	而 鸟
瓠	夸 瓜
匏	夸 包
厩	厂 既
龚	龙 共
殒	歹 员
殓	歹 佥
殍	歹 孚
赉	来 贝
雩	雨 亏
辄	车 耳 乚
堑	斩 土
眭	目 圭
眦	目 此
啧	口 责
晡	日 甫
晤	日 吾
眺	目 兆
眵	目 多
眸	目 牟
圊	囗 青
喏	口 若
喵	口 苗
啉	口 林
勖	冒 力
晞	日 希
唵	口 奄
晗	日 含
冕	日 免
啭	口 转
畦	田 圭
趺	足 夫
啮	口 齿
跄	足 仓
蚶	虫 甘
蛄	虫 古
蛎	虫 厉
蛆	虫 且
蚰	虫 由
蛊	虫 皿
圉	囗 幸
蚱	虫 乍
蛉	虫 令
蛏	虫 圣
蚴	虫 幼
啁	口 周
啕	口 勹 缶
唿	口 忽
啐	口 卒
唼	口 妾
唷	口 育
啖	口 炎
啵	口 波
啶	口 定
啷	口 郎
唳	口 戾
唰	口 刷
啜	口 叕
帻	巾 责
崚	山 土 八 夂
崦	山 奄
帼	巾 国
崮	山 固
崤	山 肴
崆	山 空
赇	贝 求
赈	贝 辰
赊	贝 佘
铑	钅 老
铒	钅 耳
铗	钅 夹
铙	钅 尧
铟	钅 因
铠	钅 岂
铡	钅 则
铢	钅 朱
铣	钅 先
铤	钅 廷
铧	钅 华
铨	钅 全
铩	钅 杀
铪	钅 合
铫	钅 兆
铬	钅 各
铮	钅 争
铯	钅 色
铰	钅 交
铱	钅 衣
铳	钅 充
铵	钅 安
铷	钅 如
氪	气 克
牾	牛 吾
鸹	舌 鸟
秾	禾 农
逶	辶 委
笺	⺮ 戈
筇	⺮ 邛
笸	⺮ 叵
笪	⺮ 旦
笮	⺮ 乍
笠	⺮ 立
笥	⺮ 司
笤	⺮ 召
笳	⺮ 加
笾	⺮ 边
笞	⺮ 台
偾	亻 贲
偃	亻 匚 日 女
偕	亻 皆
偈	亻 曷
傀	亻 鬼
偬	亻 匆 心
偻	亻 娄
皑	白 岂
皎	白 交
鸻	行 鸟
徜	彳 尚
舸	舟 可
舻	舟 卢
舴	舟 乍
舷	舟 玄
龛	合 龙
翎	令 羽
脬	月 孚
脘	月 完
脲	月 尿
匐	勹 一 口 田
猗	犭 奇
猡	犭 罗
猞	犭 舍
猝	犭 卒
斛	角 斗
猕	犭 弥
馗	九 首
馃	饣 果
馄	饣 昆
鸾	SK 鸟
孰	享 丸
庹	广 廿 尺
庾	广 臾
痔	疒 寺
痍	疒 夷
疵	疒 此
翊	立 羽
旌	方 𠂉 生
旎	方 𠂉 尼
袤	亠 矛 氏
阇	门 者
阈	门 或
阉	门 奄
阊	门 昌
阋	门 臼 儿
阍	门 昏
阏	门 於
羟	羊 XS 工
粝	米 厉
粕	米 白
敝	水 冂 攵
焐	火 吾
烯	火 希
焓	火 含
烽	火 夂 丰
焖	火 闷
烷	火 完
焗	火 局
渍	氵 责
渚	氵 者
淇	氵 其
淅	氵 析
淞	氵 松
渎	氵 卖
涿	氵 豕 丶
淖	氵 卓
挲	沙 手
淠	氵 畀
涸	氵 固
渑	氵 黾
淦	氵 金
淝	氵 肥
淬	氵 卒
涪	氵 立 口
淙	氵 宗
涫	氵 官
渌	氵 录
淄	氵 甾
惬	忄 匚 夹
悻	忄 幸
悱	忄 非
惝	忄 尚
惘	忄 LD
悸	忄 季
惆	忄 周
惚	忄 忽
惇	忄 享
惮	忄 单
窕	穴 兆
谌	讠 甚
谏	讠 柬
扈	户 邑
皲	军 皮
谑	讠 虐
裆	衤 当
袷	衤 合
裉	衤 艮
谒	讠 曷
谔	讠 口 口 亏
谕	讠 俞
谖	讠 爰
谗	讠 免 TD
谙	讠 音
谛	讠 帝
谝	讠 扁
逯	辶 录
郿	眉 阝
隈	阝 畏
粜	出 米
隍	阝 皇
隗	阝 鬼
婧	女 青
婊	女 表
婕	女 一 彐 止
娼	女 昌
婢	女 卑
婵	女 单
胬	奴 肉
袈	加 衣
翌	羽 立
恿	甬 心
欸	矣 欠
绫	纟 土 八 夂
骐	马 其
绮	纟 奇
绯	纟 非
绱	纟 尚
骒	马 果
绲	纟 昆
骓	马 隹
绶	纟 受
绺	纟 咎
绻	纟 卷
绾	纟 官
骖	马 参
缁	纟 甾
耠	耒 合
琫	王 奉
琵	王 王 比
琶	王 王 巴
琪	王 其
瑛	王 英
琦	王 奇
琥	王 虎
琨	王 昆
靓	青 见
琰	王 炎
琮	王 宗
琯	王 官
琬	王 宛
琛	王 ⺳ 木
琚	王 居
辇	夫 夫 车
鼋	元 黾
揳	扌 契
堞	土 世 木
搽	扌 茶
揸	扌 查
揠	扌 匚 日 女
堙	土 西 土
趄	走 且
揖	扌 口 耳
颉	吉 页
塄	土 四 方
揿	扌 钦
耋	老 至
揄	扌 俞
蛩	巩 虫
蛰	执 虫
塆	土 弯
摒	扌 屏
揆	扌 癸
掾	扌 彖
聒	耳 舌
葑	艹 封
葚	艹 甚
靰	革 兀
靸	革 及
葳	艹 威
葺	艹 口 耳
葸	艹 思
萼	艹 口 口 亏
葆	艹 保
葩	艹 白 巴
葶	艹 亭
蒌	艹 娄
萱	艹 宣
戟	龺 戈
葭	艹 叚
楮	木 者
棼	林 分
椟	木 卖
棹	木 卓
椤	木 罗
棰	木 垂
赍	十 人 人 冖 贝
椋	木 京
椁	木 享
椪	木 UA 业
棣	木 隶
椐	木 居
鹁	孛 鸟
覃	西 早
酤	酉 古
酢	酉 乍
酡	酉 它
鹂	丽 鸟
厥	厂 UA 屮 欠
殚	歹 单
殛	歹 亟
雯	雨 文
雱	雨 方
辊	车 昆
辋	车 LD
椠	斩 木
辍	车 叕
辎	车 甾
斐	非 文
睄	目 肖
睑	目 佥
睇	目 弟
睃	目 厶 八 夂
戢	口 耳 戈	# 横笔拆断
喋	口 世 木
嗒	口 艹 合
喃	口 南
喱	口 厘
喹	口 奎
晷	日 咎
喈	口 皆
跖	足 石
跗	足 付
跞	足 乐
跚	足 册
跎	足 它
跏	足 加
跆	足 台
蛱	虫 夹
蛲	虫 尧
蛭	虫 至
蛳	虫 师
蛐	虫 曲
蛔	虫 回
蛞	虫 舌
蛴	虫 齐
蛟	虫 交
蛘	虫 羊
喁	口 禺
喟	口 胃
啾	口 秋
嗖	口 叟
喑	口 音
嗟	口 差
喽	口 娄
嗞	口 兹
喀	口 客
喔	口 屋
喙	口 彖
嵘	山 荣
嵖	山 查
崴	山 威
遄	辶 耑
詈	四 言
嵎	山 禺
崽	山 思
嵬	山 鬼
嵛	山 俞
嵯	山 差
嵝	山 娄
嵫	山 兹
幄	巾 屋
嵋	山 眉
赕	贝 炎
铻	钅 吾
铼	钅 来
铿	钅 坚
锃	钅 呈
锂	钅 里
锆	钅 告
锇	钅 我
锉	钅 坐
锏	钅 间
锑	钅 弟
锒	钅 良
锔	钅 局
锕	钅 阿
掣	制 手
矬	矢 坐
氰	气 青
毳	毛 毛 毛
毽	毛 建
犊	牛 卖
犄	牛 奇
犋	牛 具
鹄	告 鸟
犍	牛 建
嵇	禾 尤 山
黍	禾 人 水
稃	禾 孚
稂	禾 良
筚	⺮ 毕
筵	⺮ 延
筌	⺮ 全
傣	亻 泰
傈	亻 栗
舄	臼 勹 灬
牍	片 卖
傥	亻 党
傧	亻 宾
遑	辶 皇
傩	亻 难
遁	辶 盾
徨	彳 皇
媭	须 女
畲	佘 田
弑	杀 式
颌	合 页
翕	合 羽
釉	釆 由
鹆	谷 鸟
舜	爪 冖 舛
貂	豸 召
腈	月 青
腌	月 奄
腓	月 非
腆	月 典
腴	月 臾
腑	月 府
腚	月 定
腱	月 建
鱿	鱼 尤
鲀	鱼 屯
鲂	鱼 方
颍	匕 水 页
猢	犭 胡
猹	犭 查
猥	犭 畏
飓	风 具
觞	角 𠂉 Y OD
觚	角 瓜
猱	犭 柔
颎	匕 火 页
飧	夕 食
馇	饣 查
馊	饣 叟
亵	亠 执 氏
脔	SK 肉
裒	亠 臼 氏
痣	疒 志
痨	疒 劳
痦	疒 吾
痞	疒 否
痤	疒 坐
痫	疒 闲
痧	疒 沙
赓	庚 贝
竦	立 束
瓿	立 口 瓦
啻	帝 口
颏	亥 页
鹇	闲 鸟
阑	门 柬
阒	门 目 犬
阕	门 癸
粞	米 西
遒	辶 酋
孳	兹 子
焯	火 卓
焜	火 昆
焙	火 立 口
焱	火 火 火
鹈	弟 鸟
湛	氵 甚
渫	氵 世 木
湮	氵 西 土
湎	氵 面
湜	氵 是
渭	氵 胃
湍	氵 耑
湫	氵 秋
溲	氵 叟
湟	氵 皇
溆	氵 叙
湲	氵 爰
湔	氵 前
湉	氵 恬
渥	氵 屋
湄	氵 眉
滁	氵 除
愠	忄 日 皿
惺	忄 星
愦	忄 贵
惴	忄 耑
愀	忄 秋
愎	忄 复
愔	忄 音
喾	VD 冖 告
寐	宀 爿 未
谟	讠 莫
扉	户 非
裢	衤 连
裎	衤 呈
裥	衤 间
祾	礻 土 八 夂
祺	礻 其
谠	讠 党
幂	冖 日 大 巾
谡	讠 田 八 夂
谥	讠 益
谧	讠 必 皿
遐	辶 叚
孱	尸 子 子 子
弼	弓 百 弓
巽	巳 巳 共
骘	阝 步 马
媪	女 日 皿
媛	女 爰
婷	女 亭
巯	XS 工 亠 厶 川
翚	羽 军
皴	厶 八 夂 皮
婺	矛 攵 女
骛	矛 攵 马
缂	纟 革
缃	纟 相
缄	纟 咸
彘	彑 匕 矢 匕
缇	纟 是
缈	纟 目 少
缌	纟 思
缑	纟 侯
缒	纟 追
缗	纟 民 日
飨	乡 食
耢	耒 劳
瑚	王 胡
瑁	王 冒
瑜	王 俞
瑗	王 爰
瑄	王 宣
瑕	王 叚
遨	辶 敖
骜	敖 马
韫	韦 日 皿
髡	髟 兀
塬	土 原
鄢	焉 阝
趔	走 列
趑	走 次
摅	扌 虑
摁	扌 恩
蜇	折 虫
搋	扌 虒
搪	扌 唐
搐	扌 畜
搛	扌 兼
搠	扌 朔
摈	扌 宾
彀	士 冖 一 弓 殳
毂	士 冖 车 殳	# 简体字壳字头下少一横，不影响编码
搦	扌 弱
搡	扌 桑
蓁	艹 秦
戡	甚 戈
蓍	艹 耆
鄞	堇 阝
靳	革 斤
蓐	艹 辱
蓦	莫 马
鹋	苗 鸟
蒽	艹 恩
蓓	艹 倍
蓖	艹 囟 比
蓊	艹 翁
蒯	艹 朋 刂
蓟	艹 鱼 刂
蓑	艹 衰
蒿	艹 高
蒺	艹 疾
蓠	艹 离
蒟	艹 立 句
蒡	艹 旁
蒹	艹 兼
蒴	艹 朔
蒗	艹 浪
蓥	艹 冖 金
颐	H 页
楔	木 契
楠	木 南
楂	木 查
楝	木 柬
楫	木 口 耳
楸	木 秋
椴	木 段
槌	木 追
楯	木 盾
皙	析 白
榈	木 闾
槎	木 差
榉	木 举
楦	木 宣
楣	木 眉
楹	木 盈
椽	木 彖
裘	求 衣
剽	票 刂
甄	西 土 瓦
酮	酉 同
酰	酉 先
酯	酉 旨
酩	酉 名
蜃	辰 虫
碛	石 责
碓	石 隹
硼	石 朋
碉	石 周
碚	石 立 口
碇	石 定
碜	石 参
鹌	奄 鸟
辏	车 奏
龃	齿 且
龅	齿 包
訾	此 言
粲	卜 夕 又 米
虞	虍 吴
睚	目 厂 圭
嗪	口 秦
韪	是 韦
嗷	口 敖
嗉	口 素
睨	目 臼 儿
睢	目 隹
雎	且 隹
睥	目 卑
嘟	口 都
嗑	口 盍
嗫	口 聂
嗬	口 荷
嗔	口 真
嗝	口 鬲
戥	星 戈
嗄	口 夏
煦	日 句 灬
暄	日 宣
遢	辶 日 羽
暌	日 癸
跬	足 圭
跶	足 达
跸	足 毕
跐	足 此
跣	足 先
跹	足 迁
跻	足 齐
蛸	虫 肖
蜊	虫 利
蜍	虫 余
蜉	虫 孚
蜣	虫 羌
畹	田 宛
蛹	虫 甬
嗣	口 LD 司
嗯	口 恩
嗥	口 白 大 十
嗲	口 爹
嗳	口 爱
嗌	口 益
嗍	口 朔
嗨	口 海
嗐	口 害
嗤	口 蚩
嗵	口 通
罨	四 奄
嵊	山 乘
嵩	山 高
嵴	山 脊
骰	骨 殳
锗	钅 者
锛	钅 奔
锜	钅 奇
锝	钅 日 一 寸
锞	钅 果
锟	钅 昆
锢	钅 固
锨	钅 欣
锩	钅 卷
锭	钅 定
锱	钅 甾
雉	矢 隹
氲	气 日 皿
犏	牛 扁
歃	千 臼 欠
稞	禾 果
稗	禾 卑
稔	禾 念
筠	⺮ 均
筢	⺮ 把
筮	⺮ 巫
筲	⺮ 肖
筱	⺮ 攸
牒	片 世 木
煲	保 火
敫	白 方 攵
徭	彳 爪 缶
愆	衍 心
艄	舟 肖
觎	俞 见
毹	俞 毛
貊	豸 百
貅	豸 休
貉	豸 各
颔	含 页
腠	月 奏
腩	月 南
腼	月 面
腭	月 口 口 亏
腧	月 俞
塍	月 龹 土
媵	月 龹 女
詹	⺈ 厂 八 言
鲅	鱼 友 丶
鲆	鱼 平
鲇	鱼 占
鲈	鱼 卢
稣	鱼 禾
鲋	鱼 付
鲐	鱼 台
肄	匕 矢 聿
鹐	⺈ 臼 鸟
飕	风 叟
觥	角 光
遛	辶 留
馐	饣 羞
鹑	享 鸟
亶	亠 回 旦
瘃	疒 豕 丶
痱	疒 非
痼	疒 固
痿	疒 委
瘐	疒 臾
瘁	疒 卒
瘆	疒 参
麂	鹿 几
裔	衣 LD
歆	音 欠
旒	方 𠂉 亠 厶 川
雍	亠 乡 隹
阖	门 盍
阗	门 真
阙	门 UA 屮 欠
羧	羊 厶 八 夂
豢	龹 豕
粳	米 更
猷	酋 犬
煳	火 胡
煜	火 日 立
煨	火 畏
煅	火 段
煊	火 宣
煸	火 扁
煺	火 退
滟	氵 艳
溱	氵 秦
溘	氵 盍
漭	氵 莽
滢	氵 莹
溥	氵 甫 寸
溧	氵 栗
溽	氵 辱
裟	沙 衣
溻	氵 日 羽
溷	氵 囗 豕
滗	氵 笔
滫	氵 脩
溴	氵 臭
滏	氵 釜
滃	氵 翁
滦	氵 栾
溏	氵 唐
滂	氵 旁
滓	氵 宰
溟	氵 冥
滪	氵 预
愫	忄 素
慑	忄 聂
慊	忄 兼
鲎	VD 冖 鱼
骞	宀 甘 八 马
窦	穴 卖
窠	穴 果
窣	穴 卒
裱	衤 表
褚	衤 者
裨	衤 卑
裾	衤 居
裰	衤 叕
禊	礻 契
谩	讠 曼
谪	讠 亠 丷 LD
媾	女 甘 冉
嫫	女 莫
媲	女 囟 比
嫒	女 爱
嫔	女 宾
媸	女 蚩
缙	纟 晋
缜	纟 真
缛	纟 辱
辔	纟 车 纟 口
骝	马 留
缟	纟 高
缡	纟 离
缢	纟 益
缣	纟 兼
骟	马 扇
耥	耒 尚
璈	王 敖
瑶	王 爪 缶
瑭	王 唐
獒	敖 犬
觏	甘 冉 见
慝	匿 心
嫠	未 攵 厂 女
韬	韦 舀
叆	云 爱
髦	髟 毛
摽	扌 票
墁	土 曼
撂	扌 田 各
摞	扌 累
撄	扌 婴
翥	者 羽
踅	折 足
摭	扌 庶
墉	土 庸
墒	土 商
榖	士 冖 一 木 殳	# 非“禾”
綦	其 糸
蔫	艹 焉
蔷	艹 啬
靺	革 末
靼	革 旦
鞅	革 央
靿	革 幼
甍	艹 四 冖 瓦
蔸	艹 兜
蔟	艹 族
蔺	艹 门 隹
戬	晋 戈
蕖	艹 渠
蔻	艹 宀 元 攴
蓿	艹 宿
斡	龺 人 斗
鹕	胡 鸟
蓼	艹 羽 人 彡
榛	木 秦
榧	木 匪
榻	木 日 羽
榫	木 隼
榭	木 射
槔	木 皋
榱	木 衰
槁	木 高
槟	木 宾
槠	木 诸
榷	木 隺
僰	棘 人
酽	酉 严
酶	酉 每
酹	酉 爪 寸
厮	厂 斯
碡	石 毒
碴	石 查
碣	石 曷
碲	石 帝
磋	石 差
臧	戈 爿 臣
豨	豕 希
殡	歹 宾
霆	雨 廷
霁	雨 齐
辕	车 袁
蜚	非 虫
裴	非 衣
翡	非 羽
龇	齿 此
龈	齿 艮
睿	卜 冖 一 八 人 目
䁖	目 娄
睽	目 癸
嘞	口 勒
嘈	口 曹
嘌	口 票
嘁	口 戚
嘎	口 戛
暧	日 爱
暝	日 冥
踌	足 寿
踉	足 良
蜞	虫 其
蜥	虫 析
蜮	虫 或
蝈	虫 国
蜴	虫 易
蜱	虫 卑
蜩	虫 周
蜷	虫 卷
蜿	虫 宛
螂	虫 郎
蜢	虫 孟
嘘	口 虚
嘡	口 堂
鹗	口 口 亏 鸟
嘣	口 崩
嘤	口 婴
嘚	口 得
嗾	口 族
嘧	口 密
罴	罢 灬
罱	四 南
幔	巾 曼
嶂	山 章
幛	巾 章
赙	贝 甫 寸
罂	贝 贝 缶
骷	骨 古
骶	骨 氐
鹘	骨 鸟
锲	钅 契
锴	钅 皆
锶	钅 思
锷	钅 口 口 亏
锸	钅 千 臼
锵	钅 将
镁	钅 美
镂	钅 娄
犒	牛 高
箐	⺮ 青
箦	⺮ 责
箧	⺮ 匚 夹
箍	⺮ 扌 匝
箸	⺮ 者
箬	⺮ 若
箅	⺮ 畀
箪	⺮ 单
箔	⺮ 泊
箜	⺮ 空
箢	⺮ 宛
箓	⺮ 录
毓	每 亠 厶 川
僖	亻 喜
儆	亻 敬
僳	亻 粟
僭	亻 H 儿 H 儿 日
劁	焦 刂
僮	亻 童
魃	鬼 友 丶
魆	鬼 戈 Z
睾	丿 四 幸
艋	舟 孟
鄱	番 阝
膈	月 鬲
膑	月 宾
鲑	鱼 圭
鲔	鱼 有
鲚	鱼 齐
鲛	鱼 交
鲟	鱼 寻
獐	犭 章
觫	角 束
雒	各 隹
夤	夕 寅
馑	饣 堇
銮	SK 金
塾	孰 土
麽	广 林 么
瘌	疒 剌
瘊	疒 侯
瘘	疒 娄
瘙	疒 蚤
廖	广 羽 人 彡
韶	音 召
旖	方 𠂉 奇
膂	旅 月
阚	门 敢
鄯	善 阝
鲞	龹 鱼
粿	米 果
粼	米 舛 巜
粽	米 宗
糁	米 参
槊	朔 木
鹚	兹 鸟
熘	火 留
熥	火 通
潢	氵 黄
漕	氵 曹
滹	氵 虍 乎
漯	氵 累	
漶	氵 患
潋	氵 敛
潴	氵 猪
漪	氵 猗
漉	氵 鹿
漳	氵 章
漩	氵 旋
澉	氵 敢
潍	氵 维
慵	忄 庸
搴	宀 甘 八 手
窨	穴 音
寤	宀 爿 吾
綮	户 攵 糸
谮	讠 H 儿 H 儿 日
褡	衤 艹 合
褙	衤 背
褓	衤 保
褛	衤 娄
褊	衤 扁
谯	讠 焦
谰	讠 阑
谲	讠 矞
暨	既 旦
屣	尸 徙
鹛	眉 鸟
嫣	女 焉
嫱	女 啬
嫖	女 票
嫦	女 常
嫚	女 曼
嫘	女 累
嫡	女 亠 丷 LD
鼐	乃 鼎
翟	羽 隹
瞀	矛 攵 目
鹜	矛 攵 鸟
骠	马 票
缥	纟 票
缦	纟 曼
缧	纟 累
缨	纟 婴
骢	马 囱 心
缪	纟 羽 人 彡
缫	纟 巢
耦	耒 禺
耧	耒 娄
瑾	王 堇
璜	王 黄
璀	王 崔
璎	王 婴
璁	王 囱 心
璋	王 章
璇	王 旋
奭	大 百 百
髯	髟 冉
髫	髟 召
撷	扌 颉
撅	扌 厥
赭	赤 者
撸	扌 鲁
鋆	均 金
撙	扌 尊
撺	扌 窜
墀	土 犀
聩	耳 贵
觐	堇 见
鞑	革 达
蕙	艹 惠
鞒	革 乔
蕈	艹 覃
蕨	艹 厥
蕤	艹 豕 生
蕞	艹 最
蕺	艹 戢
瞢	艹 四 冖 目
蕃	艹 番
蕲	艹 单 斤
赜	臣 责
槿	木 堇
樯	木 啬
槭	木 戚
樗	木 雩
樘	木 堂
樊	木 爻 木 大
槲	木 斛
醌	酉 昆
醅	酉 立 口
靥	厂 犬 面
魇	厂 犬 鬼
餍	厂 犬 食
磔	石 桀
磙	石 衮
霈	雨 沛
辘	车 鹿
龉	齿 吾
龊	齿 足
觑	虚 见
瞌	目 盍
瞋	目 真
瞑	目 冥
嘭	口 彭
噎	口 壹
噶	口 葛
颙	禺 页
暹	辶 日 隹
噘	口 厥
踔	足 卓
踝	足 果
踟	足 知
踒	足 委
踬	足 质
踮	足 店
踯	足 郑
踺	足 建
踞	足 居
蝽	虫 春
蝾	虫 荣
蝻	虫 南
蝰	虫 奎
蝮	虫 复
螋	虫 叟
蝓	虫 俞
蝣	虫 方 𠂉 子
蝼	虫 娄
噗	口 业 羊
嘬	口 最
颚	口 口 亏 页
噍	口 焦
噢	口 奥
噙	口 禽
噜	口 鲁
噌	口 曾
噔	口 登
颛	耑 页
幞	巾 业 羊
幡	巾 番
嶙	山 米 舛
嶝	山 登
骺	骨 后
骼	骨 各
骸	骨 亥
镊	钅 聂
镉	钅 鬲
镌	钅 隽
镍	钅 臬
镏	钅 留
镒	钅 益
镓	钅 家
镔	钅 宾
稷	禾 田 八 夂
箴	⺮ 咸
篑	⺮ 贵
篁	⺮ 皇
篌	⺮ 侯
篆	⺮ 彖
牖	片 户 甫
儋	亻 詹
徵	彳 山 一 王 攵
磐	般 石
虢	爪 寸 虎
鹞	爪 缶 鸟
膘	月 票
滕	月 龹 水
鲠	鱼 更
鲡	鱼 丽
鲢	鱼 连
鲣	鱼 坚
鲥	鱼 时
鲧	鱼 系
鲩	鱼 完
獗	犭 厥
獠	犭 大 丷 日 小
觯	角 单
馓	饣 散
馔	饣 巽
麾	广 林 毛
廛	广 里 八 土
瘛	疒 丰 刀 心
瘼	疒 莫
瘢	疒 般
瘠	疒 脊
齑	文 ND 韭
羯	羊 曷
羰	羊 炭
𥻗	米 查
遴	辶 米 舛
糌	米 处 日
糍	米 兹
糅	米 柔
熜	火 囱 心
熵	火 商
熠	火 羽 白
澍	氵 士 口 UA 寸
澌	氵 斯
潸	氵 林 月
潦	氵 大 丷 日 小
潲	氵 稍
鋈	沃 金
潟	氵 舄
潼	氵 童
潺	氵 孱
憬	忄 景
憧	忄 童
寮	宀 大 丷 日 小
窳	穴 瓜 瓜
谳	讠 献
褴	衤 监
褟	衤 日 羽
褫	衤 虒
谵	讠 詹
熨	尉 火
屦	尸 彳 娄
嬉	女 喜
勰	力 力 力 思
戮	羽 人 彡 戈
蝥	矛 攵 虫
缬	纟 颉
缮	纟 善
缯	纟 曾
骣	马 孱
畿	幺 幺 戈 田
耩	耒 甘 冉
耨	耒 辱
耪	耒 旁
璞	王 业 羊
璟	王 景
靛	青 定
璠	王 番
璘	王 米 舛
聱	敖 耳
螯	敖 虫
髻	髟 吉
髭	髟 此
髹	髟 休
擀	扌 龺 人 干
熹	喜 灬
甏	彭 瓦
擞	扌 数
縠	士 冖 一 糸 殳
磬	声 殳 石
颞	聂 页
蕻	艹 CH 共
鞘	革 肖
颟	𬜯 页
薤	艹 歹 韭
薨	艹 四 冖 死
檠	敬 木
薏	艹 意
薮	艹 数
薜	艹 辟
薅	艹 女 辱
樾	木 越
橛	木 厥
橇	木 毛 毛 毛
樵	木 焦
檎	木 禽
橹	木 鲁
樽	木 尊
樨	木 犀
橼	木 缘
墼	FK 凵 殳 土
橐	一 中 冖 石 木
翮	鬲 羽
醛	酉 艹 全
醐	酉 胡
醍	酉 是
醚	酉 迷
磲	石 渠
赝	雁 贝
飙	犬 犬 犬 风
殪	歹 壹
霖	雨 林
霏	雨 非
霓	雨 臼 儿
錾	斩 金
辚	车 米 舛
臻	至 秦
遽	辶 虍 豕
氅	敞 毛
瞟	目 票
瞠	目 堂
瞰	目 敢
嚄	口 艹 隹 又
嚆	口 蒿
噤	口 禁
暾	日 敦
蹀	足 世 木
踹	足 耑
踵	足 重
踽	足 禹
蹉	足 差
蹁	足 扁
螨	虫 𬜯
蟒	虫 莽
螈	虫 原
螅	虫 息
螭	虫 离
螠	虫 益
螟	虫 冥
噱	口 虍 豕
噬	口 ⺮ 巫
噫	口 意
噻	口 塞
噼	口 辟
罹	四 忄 隹
圜	囗 四 一 口 氏
䦃	钅 著
镖	钅 票
镗	钅 堂
镘	钅 曼
镚	钅 崩
镛	钅 庸
镝	钅 亠 丷 LD
镞	钅 族
镠	钅 习 人 彡
氇	毛 鲁
氆	毛 普
憩	舌 自 心
穑	禾 啬
篝	⺮ 甘 冉
篥	⺮ 栗
篦	⺮ 囟 比
篪	⺮ 虒
篙	⺮ 高
盥	臼 水 皿
劓	鼻 刂
翱	皋 羽
魉	鬼 两
魈	鬼 肖
徼	彳 敫
歙	翕 欠
膳	月 善
膦	月 米 舛
膙	月 强
鲮	鱼 土 八 夂
鲱	鱼 非
鲲	鱼 昆
鲳	鱼 昌
鲴	鱼 固
鲵	鱼 臼 儿
鲷	鱼 周
鲻	鱼 甾
獴	犭 蒙
獭	犭 赖
獬	犭 解
邂	辶 解
鹧	庶 鸟
廨	广 解
赟	斌 贝
瘰	疒 累
廪	广 禀
瘿	疒 婴
瘵	疒 祭
瘴	疒 章
癃	疒 隆
瘳	疒 羽 人 彡
斓	文 阑
麇	鹿 禾
麈	鹿 主
嬴	亡 口 月 女 凡
壅	雍 土
羲	羊 禾 一 Z 戈	# 横笔拆断
糗	米 臭
瞥	敝 目
甑	曾 瓦
燎	火 大 丷 日 小
燠	火 奥
燔	火 番
燧	火 遂
濑	氵 赖
濉	氵 睢
潞	氵 路
澧	氵 曲 豆
澹	氵 詹
澥	氵 解
澶	氵 亶
濂	氵 廉
褰	宀 甘 八 衣
寰	宀 四 一 口 氏
窸	穴 悉
褶	衤 羽 白
禧	礻 喜
嬖	辟 女
犟	强 牛
隰	阝 㬎
嬗	女 亶
颡	桑 页
缱	纟 遣
缲	纟 品 木
缳	纟 四 一 口 氏
璨	王 粲
璩	王 虍 豕
璐	王 路
璪	王 品 木
螫	赤 攵 虫
擤	扌 鼻
壕	土 豪
觳	士 冖 一 角 殳
罄	声 殳 缶
擢	扌 翟
薹	艹 吉 冖 至
鞡	革 拉
鞬	革 建
薷	艹 需
薰	艹 熏
藓	艹 鲜
藁	蒿 木
檄	木 敫
檩	木 禀
懋	楙 心
醢	酉 右 皿
翳	医 殳 羽
礅	石 敦
磴	石 登
鹩	大 丷 日 小 鸟
龋	齿 禹
龌	齿 屋
豳	豕 豕 山
壑	卜 冖 一 谷 又 土
黻	黹 友 丶
嚏	口 疐
嚅	口 需
蹑	足 聂
蹒	足 𬜯
蹊	足 奚
蟥	虫 黄
螬	虫 曹
螵	虫 票
疃	田 童
螳	虫 堂
蟑	虫 章
嚓	口 察
羁	四 革 马
罽	四 厂 炎 刂
罾	四 曾
嶷	山 疑
黜	黑 出
黝	黑 幼
髁	骨 果
髀	骨 卑
镡	钅 覃
镢	钅 厥
镣	钅 大 丷 日 小
镦	钅 敦
镧	钅 阑
镩	钅 窜
镪	钅 强
镫	钅 登
罅	缶 虍 乎
黏	黍 占
簌	⺮ 束 欠
篾	⺮ 四 戍
篼	⺮ 兜
簖	⺮ 断
簋	⺮ 艮 皿
鼢	鼠 分
黛	代 黑
儡	亻 田 田 田
鹪	焦 鸟
鼾	鼻 干
皤	白 番
魍	鬼 LD
龠	人 一 口 口 口 LD
繇	爪 缶 系
貘	豸 莫
邈	辶 貌
貔	豸 囟 比
臌	月 鼓
膻	月 亶
臆	月 意
臃	月 雍
鲼	鱼 贲
鲽	鱼 世 木
鳀	鱼 是
鳃	鱼 思
鳅	鱼 秋
鳇	鱼 皇
鳊	鱼 扁
螽	冬 虫 虫
燮	火 言 火 又
鹫	就 鸟
襄	亠 口 口 甘 氏
糜	广 林 米
縻	广 林 糸
膺	广 亻 隹 月
癍	疒 斑
麋	鹿 米
懑	满 心
濡	氵 需
濮	氵 亻 业 羊
濞	氵 鼻
濠	氵 豪
濯	氵 翟
蹇	宀 甘 八 足
謇	宀 甘 八 言
邃	辶 穴 丷 豕
襁	衤 强
檗	辟 木
擘	辟 手
孺	子 需
隳	隋 人 ⺗
嬷	女 麽
蟊	矛 虫 虫
鹬	矞 鸟
鍪	矛 攵 金
鏊	敖 金
鳌	敖 鱼
鬈	髟 卷
鬃	髟 宗
瞽	鼓 目
鞯	革 荐
鞨	革 曷
鞫	革 訇
鞧	革 酋
鞣	革 柔
藜	艹 黎
藠	艹 白 白 白
藩	艹 潘
醪	酉 羽 人 彡
蹙	戚 足
礓	石 三 田 田
燹	豕 豕 火
餮	殄 食
瞿	目 目 隹
曛	日 熏
颢	景 页
曜	日 翟
躇	足 著
蹚	足 堂
鹭	路 鸟
蟛	虫 彭
蟪	虫 惠
蟠	虫 番
蟮	虫 善
鹮	四 一 口 氏 鸟
黠	黑 吉
黟	黑 多
髅	骨 娄
髂	骨 客
镬	钅 艹 隹 又
镭	钅 雷
镯	钅 蜀
馥	香 复
簟	⺮ 覃
簪	⺮ H 儿 H 儿 日
鼬	鼠 由
雠	隹 讠 隹
艟	舟 童
鳎	鱼 日 羽
鳏	鱼 四 水
鳐	鱼 爪 缶
癞	疒 赖
癔	疒 意
癜	疒 殿
癖	疒 辟
糨	米 强
蹩	敝 足
鎏	流 金
懵	忄 瞢
彝	彑 米 糸 廾
邋	辶 巛 囗 乂 ZD
鬏	髟 秋
攉	扌 霍
攒	扌 赞
鞲	革 甘 冉
鞴	革 EA 丿 LD
藿	艹 霍
蘧	艹 遽
蘅	艹 衡
麓	林 鹿
醮	酉 焦
醯	酉 亠 厶 川 皿
酃	雨 口 口 口 阝
霪	雨 淫
霭	雨 谒
霨	雨 尉
黼	黹 甫
嚯	口 霍
蹰	足 厨
蹶	足 厥
蹽	足 大 丷 日 小
蹼	足 业 羊
蹴	足 就
蹾	足 敦
蹿	足 窜
蠖	虫 艹 隹 又
蠓	虫 蒙
蟾	虫 詹
蠊	虫 廉
黢	黑 厶 八 夂
髋	骨 宽
髌	骨 宾
镲	钅 察
籀	⺮ 扌 留
籁	⺮ 赖
齁	鼻 句
魑	鬼 离
艨	舟 蒙
鳓	鱼 勒
鳔	鱼 票
鳕	鱼 雪
鳗	鱼 曼
鳙	鱼 庸
麒	鹿 其
鏖	鹿 金
羸	亡 口 月 羊 凡
㸆	火 靠
瀚	氵 翰
瀣	氵 卜 夕 又 韭
瀛	氵 嬴
襦	衤 需
谶	讠 从 戈 韭
襞	辟 衣
骥	马 冀
缵	纟 赞
瓒	王 赞
攘	扌 襄
蘩	艹 繁
蘖	薛 木
醴	酉 曲 豆
霰	雨 散
酆	CI 阝
矍	目 目 隹 又
曦	日 羲
躅	足 蜀
鼍	口 口 田 一 黾
巉	山 ⺈ 口 比 兔
黩	黑 卖
黥	黑 京
黪	黑 参
镳	钅 鹿 灬
镴	钅 巛 囗 乂 ZD
黧	禾 勹 丿 黑
纂	⺮ 目 大 糸
璺	臼 同 玉
鼯	鼠 吾
臜	月 赞
鳜	鱼 厥
鳝	鱼 善
鳟	鱼 尊
獾	犭 艹 口 口 隹
孀	女 霜
骧	马 襄
瓘	王 艹 口 口 隹
鼙	鼓 卑
醺	酉 熏
礴	石 薄
颦	频 卑
曩	日 襄
鳢	鱼 曲 豆
癫	疒 颠
麝	鹿 射
夔	UA 止 自 巳 八 夂	# 中间部件笔顺不确定，不影响编码
爝	火 爵
灏	氵 颢
禳	礻 襄
鐾	辟 金
羼	尸 羊 羊 羊
蠡	彖 虫 虫
耱	耒 磨
懿	壹 恣
蘸	艹 酉 焦
鹳	艹 口 口 隹 鸟
霾	雨 豸 里
氍	瞿 毛
饕	号 虎 食
躐	足 巛 囗 乂 ZD
髑	骨 蜀
镵	钅 ⺈ 口 比 兔
穰	禾 襄
饔	雍 食
鬻	粥 鬲
鬟	髟 四 一 口 氏
趱	走 赞
攫	扌 矍
攥	扌 纂
颧	艹 口 口 隹 页
躜	足 赞
鼹	鼠 晏
癯	疒 瞿
麟	鹿 米 舛
蠲	益 蜀
蠹	一 中 冖 石 虫 虫
躞	足 燮
衢	行 瞿
鑫	金 金 金
灞	氵 霸
襻	衤 攀
纛	毒 且 小 系
鬣	髟 巛 囗 乂 ZD
攮	扌 囊
囔	口 囊
馕	饣 囊
戆	赣 心
爨	臼 同 林 大 火
齉	鼻 囊
