# -*- encoding: utf8 -*-
# 三级字 (1605)
亍	二 丨	# 不是“一”“丁”
尢	GR
彳	OI
卬	RH 卩
殳	QX
𠙶	了 凵
毌	ZY
邘	于 阝
戋	HM	AAA
圢	土 丁
氕	气 丿
伋	亻 及
仝	人 工
冮	冫 工
氿	氵 九
汈	氵 刁
氾	氵 ⺋
忉	忄 刀
宄	宀 九
𬣙	讠 于
讱	讠 刃
扞	扌 干
圲	土 千
圫	土 乇
芏	艹 土
芃	艹 凡
朳	木 八
朸	木 力
𨙸	支 阝
邨	屯 阝
吒	口 乇
吖	口 丫
屼	山 兀
屾	山 山
辿	辶 山
钆	钅 乚
仳	亻 比
伣	亻 见
伈	亻 心
癿	白 乚
甪	丿 LD
邠	分 阝
犴	犭 干
冱	冫 互
邡	方 阝
闫	门 三
𬇕	氵 万
汋	氵 勺
䜣	讠 斤
讻	讠 凶
𬣞	讠 宀 一
孖	子 子
𬘓	纟 川
纩	纟 广
玒	王 工
玓	王 勺
玘	王 己
玚	王 Y OD
刬	戋 刂
𫭟	土 区
坜	土 历
坉	土 屯
扽	扌 屯
𫭢	土 仑
坋	土 分
扺	扌 氏
㧑	扌 为
毐	土 毋
芰	艹 支
芣	艹 不
苊	艹 厄
苉	艹 匹
芘	艹 比
芴	艹 勿
芠	艹 文
𫇭	艹 为
芤	艹 孔
杕	木 大
杙	木 弋
杄	木 千
杧	木 亡
杩	木 马
尪	尤 王
尨	GM
轪	车 大
𫐄	车 兀
坒	比 土
芈	卝 BI
旴	日 于
旵	日 山
呙	口 内
㕮	口 父
岍	山 开
𫵷	山 历
岠	山 巨
岜	山 巴
呇	水 口
冏	冂 八 口
觃	见 子
岙	夭 山
伾	亻 丕
㑇	亻 刍
伭	亻 玄
佖	亻 必
伲	亻 尼
佁	亻 台
飏	风 Y OD
狃	犭 丑
闶	门 亢
汧	氵 开
汫	氵 井
𣲘	氵 无
𣲗	氵 韦
沄	氵 云
沘	氵 比
𬇙	氵 贝
汭	氵 内
㳇	氵 父
沇	氵 允
忮	忄 支
忳	忄 屯
忺	忄 欠
𬣡	讠 戋
祃	礻 马
诇	讠 LD
邲	必 阝
诎	讠 出
诐	讠 皮
屃	尸 贝
𫸩	弓 区
岊	巴 山
阽	阝 占
䢺	出 阝
阼	阝 乍
妧	女 元
妘	女 云
𨚕	弁 阝
纮	纟 𠂇 厶
驲	马 日
𫘜	马 文
纻	纟 宀 一
𬘘	纟 冖 儿
𫘝	马 夬
纼	纟 引
玤	王 丰
玞	王 夫
玱	王 仓
玟	王 文
邽	圭 阝
邿	寺 阝
坥	土 且
坰	土 LD
坬	土 瓜
坽	土 令
弆	去 廾
耵	耳 丁
䢼	共 阝
𦭜	艹 只
茋	艹 氐
苧	艹 宁
苾	艹 必
苠	艹 民
枅	木 开
㭎	木 LD
枘	木 内
枍	木 兮
矼	石 工
矻	石 乞
匼	匚 合
𬨂	车 氏
𬀩	日 韦
𬀪	日 见
旿	日 午
昇	日 升
昄	日 反
昒	日 勿
昈	日 户
咉	口 央
咇	口 必
咍	口 台
岵	山 古
岽	山 东
岨	山 且
岞	山 乍
峂	山 冬
㟃	山 司
囷	囗 禾
𬬩	钅 弋
钐	钅 彡
钔	钅 门
钖	钅 Y OD
牥	牛 方
佴	亻 耳
垈	代 土
侁	亻 先
侹	亻 廷
佸	亻 舌
佺	亻 全
隹	NI
㑊	亻 亦
侂	亻 广 乇
佽	亻 次
侘	亻 宅
郈	后 阝
舠	舟 刀
郐	会 阝
郃	合 阝
攽	分 攵
肭	月 内
肸	月 八 十
肷	月 欠
狉	犭 丕
狝	犭 尔
饳	饣 出
忞	文 心
於	方 人 TD
炌	火 介
炆	火 文
泙	氵 平
沺	氵 田
泂	氵 LD
泜	氵 氐
泃	氵 句
泇	氵 加
怊	忄 召
峃	VD 冖 山
穸	穴 夕
祋	礻 殳
祊	礻 方
𫍣	讠 同
𬣳	讠 艮
𬩽	寻 阝
鸤	尸 鸟
弢	弓 屮 又
弨	弓 召
陑	阝 而
𬮿	阝 岂
陎	阝 朱
𬯀	阝 齐
卺	丞 ⺋
乸	也 母
妭	女 友 丶
姈	女 令
𫰛	女 XS 工
迳	辶 XS 工
叕	双 双
𬳵	马 丕
驵	马 且
𬳶	马 LD
䌹	纟 LD
驺	马 刍
𫠊	马 玄
绋	纟 弗
绐	纟 台
砉	丰 石
耔	耒 子
㛃	丰 刀 女
玶	王 平
珇	王 且
珅	王 申
𬍛	王 乐
珋	王 卯
玹	王 玄
珌	王 必
玿	王 召
韨	韦 友 丶
垚	土 土 土
垯	土 达
垙	土 光
垲	土 岂
埏	土 延
垍	土 自
耇	耂 句
鿍	土 夂 牛
垎	土 各
垴	土 亠 凶
垟	土 羊
垞	土 宅
挓	扌 宅
垵	土 安
垏	土 聿
拶	扌 巛 夕
荖	艹 老
荁	艹 亘
荙	艹 达
荛	艹 尧
茈	艹 此
茽	艹 仲
荄	艹 亥
茺	艹 充
𬜬	艹 问
荓	艹 并
茳	艹 江
𦰡	艹 那
茛	艹 艮
荭	艹 红
㭕	木 去
柷	木 兄
柃	木 令
柊	木 冬
枹	木 包
栐	木 永
柖	木 召
郚	吾 阝
剅	豆 刂
䴓	一 巾 鸟
迺	辶 西
厖	厂 尨
砆	石 夫
砑	石 牙
砄	石 驮
耏	而 彡
奓	大 多
䶮	龙 天
轵	车 只
轷	车 乎
轹	车 乐
轺	车 召
昺	日 丙
𪾢	目 见
昽	日 龙
盷	目 匀
咡	口 耳
咺	口 亘
昳	日 失
昣	日 人 彡
哒	口 达
昤	日 令
昫	日 句
昡	日 玄
咥	口 至
昪	日 弁
虷	虫 干
虸	虫 子
哃	口 同
耑	山 而
峏	山 而
峛	山 列
𪨰	山 曲
峗	山 危
峧	山 交
帡	巾 并
钘	钅 开
𫓧	钅 夫
钜	钅 巨
𬬮	钅 长
𬬱	钅 斤
𬬭	钅 仑
钪	钅 亢
钬	钅 火
钭	钅 斗
矧	矢 引
秬	禾 巨
俫	亻 来
舁	臼 廾
俜	亻 由 一 Z
俙	亻 希
俍	亻 良
垕	后 土
衎	行 干
舣	舟 义
弇	合 廾
侴	人 一 丑 刂
鸧	仓 鸟
䏡	月 示
胠	月 去
𦙶	月 古
胈	月 友 丶
胩	月 卡
胣	月 𠂉 也
朏	月 出
飐	风 占
訄	九 言
饻	饣 衣
庤	广 寺
疢	疒 火
炣	火 可
炟	火 旦
㶲	火 LD
洭	氵 匡
洘	氵 考
洓	氵 木 冂
洿	氵 夸
㳚	氵 戍
泚	氵 此
浈	氵 贞
浉	氵 师
洸	氵 光
洑	氵 伏
洢	氵 伊
洈	氵 危
洚	氵 夂 牛
洺	氵 名
洨	氵 交
浐	氵 产
㳘	氵 充
洴	氵 并
洣	氵 米
恔	忄 交
宬	宀 成
窀	穴 屯
扂	户 占
袆	衤 韦
祏	礻 石
祐	礻 右
祕	礻 必
叚	X 二 X 又
陧	阝 日 土
陞	阝 升 土
娀	女 戎
姞	女 吉
姱	女 夸
姤	女 后
姶	女 合
姽	女 危
枲	台 木
绖	纟 至
骃	马 因
𬘡	纟 因
𬳽	马 先
𬘩	纟 廷
𫄧	纟 延
彖	彑 豕
骉	马 马 马
恝	丰 刀 心
珪	王 圭
珛	王 有
珹	王 成
琊	王 邪
玼	王 此
珖	王 光
𪟝	责 力
珽	王 廷
珦	王 向
珫	王 充
珒	王 聿
𬍤	王 寻
珢	王 艮
珕	王 力 力 力
珝	王 羽
𫭼	土 劳
埗	土 步
垾	土 旱
垺	土 孚
埆	土 角
垿	土 序
埌	土 良
埇	土 甬
莰	艹 坎
茝	艹 臣
𬜯	艹 两
鄀	若 阝
莶	艹 佥
莝	艹 坐
䓖	艹 穷
莙	艹 君
栻	木 式
桠	木 亚
𬂩	木 夹
桄	木 光
梠	木 吕
栴	木 𠂉 丹
梴	木 延
栒	木 旬
酎	酉 寸
酏	酉 也
𫠆	支 页
砵	石 本
砠	石 且
砫	石 主
砬	石 立
硁	石 XS 工
恧	而 心
翃	𠂇 厶 羽
郪	妻 阝
𨐈	车 光
辀	车 舟
辁	车 全
𬌗	牙 合
剕	非 刂
赀	此 贝
哢	口 弄
晅	日 亘
晊	日 至
唝	口 贡
哳	口 折
哱	口 孛
冔	日 吁
晔	日 华
晐	日 亥
晖	日 军
畖	田 瓜
蚄	虫 方
蚆	虫 巴
𫑡	黾 阝
帱	巾 寿
崁	山 坎
峿	山 吾
𪨶	山 大 车
崄	山 佥
帨	巾 兑
崀	山 良
赆	贝 尽
𬬸	钅 术
钷	钅 叵
𬬻	钅 卢
𬬹	钅 申
𬬿	钅 召
𬭁	钅 母
眚	生 目
甡	生 生
笫	⺮ 丿 Z 丨 丿
倻	亻 耶
倴	亻 奔
脩	亻 丨 夂 月
倮	亻 果
倕	亻 垂
倞	亻 京
𫢸	亻 单
倓	亻 炎
倧	亻 宗
衃	血 不
虒	⺁ 虎
舭	舟 比
舯	舟 中
舥	舟 巴
瓞	瓜 失
鬯	OS 凵 匕
鸰	令 鸟
脎	月 杀
朓	月 兆
胲	月 亥
虓	九 虎
鱽	鱼 刀
狴	犭 比 土
峱	犭 丑 山
狻	犭 厶 八 夂
眢	夕 ⺋ 目
𫗧	饣 束
勍	京 力
痄	疒 乍
疰	疒 主
痃	疒 玄
竘	立 句
羖	羊 殳
羓	羊 巴
桊	龹 木
敉	米 攵
烠	火 有
烔	火 同
烶	火 廷
烻	火 延
𬊈	火 寻
涍	氵 孝
浡	氵 孛
浭	氵 更
浬	氵 里
涄	氵 由 一 Z
涢	氵 员
涐	氵 我
浰	氵 利
浟	氵 攸
浛	氵 含
浼	氵 免
浲	氵 夂 丰
涘	氵 矣
悈	忄 戒
悃	忄 困
悢	忄 良
𬒈	VD 冖 石
宧	宀 臣
窅	穴 目
窊	穴 瓜
窎	穴 鸟
扅	户 多
扆	户 衣
袪	衤 去
袗	衤 人 彡
袯	衤 发
祧	礻 兆
隺	冖 隹
堲	即 土
疍	疋 旦
𨺙	阝 臼 儿
陴	阝 卑
烝	丞 灬
砮	奴 石
㛚	女 甬
哿	加 可
翀	羽 中
翂	羽 分
剟	叕 刂
𬳿	马 余
𫄨	纟 希
绤	纟 谷
骍	马 辛
𬘫	纟 完
䂮	丰 刀 石
琎	王 进
珸	王 吾
珵	王 呈
琄	王 口 月
琈	王 孚
琀	王 含
珺	王 君
掭	扌 忝
堎	土 土 八 夂
堐	土 厂 圭
埼	土 奇
掎	扌 奇
埫	土 尚
堌	土 固
晢	折 日
𫮃	土 单
掞	扌 炎
埪	土 空
壸	士 冖 亚
㙍	土 叕
聍	耳 宁
菝	艹 拔
萚	艹 择
菥	艹 析
莿	艹 刺
䓫	艹 奇
勚	贳 力
䓬	艹 卓
萆	艹 卑
菂	艹 的
菍	艹 念
菼	艹 炎
萣	艹 定
䓨	艹 冖 缶
菉	艹 录
䓛	艹 屈
梼	木 寿
梽	木 志
桲	木 孛
梾	木 来
桯	木 呈
梣	木 岑
梌	木 余
桹	木 良
敔	吾 攵
厣	厂 犬 甲
硔	石 共
鿎	石 达
硙	石 岂
硚	石 乔
硊	石 危
硍	石 艮
勔	面 力
䴕	列 鸟
龁	齿 乞
逴	辶 卓
唪	口 奉
啫	口 者
翈	甲 羽
㫰	日 良
晙	日 厶 八 夂
畤	田 寺
𬱖	由 页
趼	足 开
跂	足 支
蛃	虫 丙
蚲	虫 平
𬟽	虫 东
蚺	虫 冉
啴	口 单
䎃	冉 羽
崧	山 松
崟	山 金
崞	山 享
崒	山 卒
崌	山 居
崡	山 函
铏	钅 刑
𫓯	钅 圭
𫟹	钅 共
铕	钅 有
𫟼	钅 达
铖	钅 成
铘	钅 邪
铚	钅 至
铞	钅 吊
铥	钅 丢
铴	钅 汤
牻	牛 尨
牿	牛 告
稆	禾 吕
笱	⺮ 句
笯	⺮ 奴
偰	亻 契
偡	亻 甚
鸺	亻 木 鸟
偭	亻 面
偲	亻 思
偁	亻 爪 冉
㿠	白 光
鄅	禹 阝
偓	亻 屋
徛	彳 奇
衒	行 玄
舳	舟 由
舲	舟 令
鸼	舟 鸟
悆	余 心
鄃	俞 阝
瓻	希 瓦
䝙	豸 区
脶	月 呙
脞	月 坐
脟	月 爪 寸
䏲	月 弟
鱾	鱼 己
猇	犭 虎
猊	犭 臼 儿
猄	犭 京
觖	角 夬
𠅤	亠 思
庱	广 土 八 夂
庼	广 顷
庳	广 卑
痓	疒 至
䴔	交 鸟
竫	立 争
堃	方 方 土
阌	门 受
羝	羊 氐
羕	羊 永
焆	火 口 月
烺	火 良
焌	火 厶 八 夂
淏	氵 昊
𬇹	氵 国
淟	氵 典
淜	氵 朋
淴	氵 忽
淯	氵 育
湴	氵 UA 业
涴	氵 宛
𬍡	汤 玉
㥄	忄 土 八 夂
惛	忄 昏
惔	忄 炎
悰	忄 宗
惙	忄 叕
寁	宀 一 彐 止
逭	辶 官
𬤇	讠 西 土
𫍯	讠 咸
袼	衤 各
裈	衤 军
祲	礻 彐 冖 又
𬤊	讠 是
𫍲	讠 叟
谞	讠 胥
艴	弗 色
弸	弓 朋
弶	弓 京
𬯎	阝 贵
隃	阝 俞
婞	女 幸
娵	女 取
婼	女 若
媖	女 英
婳	女 画
婍	女 奇
婌	女 叔
婫	女 昆
婤	女 周
婘	女 卷
婠	女 官
𬘬	纟 青
𬘭	纟 林
𬴂	马 非
𫘦	马 勹 缶
绹	纟 勹 缶
𫟅	纟 京
𬘯	纟 享
骕	马 肃
𫘧	马 录
絜	丰 刀 糸
珷	王 武
琲	王 非
琡	王 叔
琟	王 隹
琔	王 定
琭	王 录
堾	土 春
堼	封 土
揕	扌 甚
㙘	土 要
堧	土 而 大
喆	吉 吉
堨	土 曷
塅	土 段
堠	土 侯
絷	执 糸
𪣻	土 娄
𡎚	土 扁
葜	艹 契
惎	其 心
萳	艹 南
葙	艹 相
靬	革 干
葴	艹 咸
蒇	艹 戊 贝
蒈	艹 皆
鄚	莫 阝
蒉	艹 贵
蓇	艹 骨
萩	艹 秋
蒐	艹 鬼
葰	艹 俊
葎	艹 律
鄑	晋 阝
蒎	艹 派
葖	艹 突
蒄	艹 冖 元 寸
萹	艹 扁
棤	木 昔
棽	林 今
棫	木 或
椓	木 豕 丶
椑	木 卑
𬃊	木 质
鹀	巫 鸟
椆	木 周
棓	木 立 口
棬	木 卷
棪	木 炎
椀	木 宛
楗	木 建
𬷕	甫 鸟
甦	更 生
酦	酉 发
觌	卖 见
奡	一 自 大 ND
皕	百 百
硪	石 我
欹	奇 欠
詟	龙 言
𫐐	车 臼 儿
辌	车 京
棐	非 木
龂	齿 斤
𬹼	齿 介
黹	业 水 冂
牚	龸 口 牙
睎	目 希
晫	日 卓
晪	日 典
晱	日 炎
𧿹	足 母
蛑	虫 牟
畯	田 厶 八 夂
斝	口 口 冖 斗
喤	口 皇
崶	山 封
嵁	山 甚
𫶇	山 带
崾	山 要
嵅	山 咸
崿	山 口 口 亏
嵚	山 钦
翙	岁 羽
𫖮	岂 页
圌	囗 耑
圐	囗 四 方
赑	贝 贝 贝
淼	水 水 水
赒	贝 周
鿏	钅 麦
铹	钅 劳
𬭊	钅 杜
铽	钅 忒
𨱇	钅 求
𫓶	钅 口 月
锊	钅 爪 寸
锍	钅 亠 厶 川
锎	钅 门 开
𬭎	钅 宏
锓	钅 彐 冖 又
犇	牛 牛 牛
颋	廷 页
稌	禾 余
筀	⺮ 圭
筘	⺮ 扣
筜	⺮ 当
筥	⺮ 吕
筅	⺮ 先
傃	亻 素
傉	亻 辱
翛	亻 丨 夂 羽
傒	亻 奚
傕	亻 隺
舾	舟 西
畬	余 田
𫖯	兆 页
脿	月 表
腘	月 国
䐃	月 囷
腙	月 宗
腒	月 居
𬱟	危 页
鲃	鱼 巴
猰	犭 契
𫛭	狂 鸟
猯	犭 耑
㺄	犭 俞
馉	饣 骨
凓	冫 栗
鄗	高 阝
𫷷	广 钦
廋	广 叟
廆	广 鬼
鄌	唐 阝
粢	次 米
遆	辶 帝
旐	方 𠂉 兆
𬮱	门 西 土
焞	火 享
𬊤	火 单
欻	炎 欠
𣸣	氵 贲
溚	氵 艹 合
溁	氵 荣
湝	氵 皆
渰	氵 弇
湓	氵 盆
㴔	氵 急
渟	氵 亭
溠	氵 差
渼	氵 美
溇	氵 娄
湣	氵 民 日
湑	氵 胥
溞	氵 蚤
愐	忄 面
愃	忄 宣
敩	学 攵
甯	宀 心 LD
棨	户 攵 木
扊	户 炎
裣	衤 佥
祼	礻 果
婻	女 南
媆	女 而 大
媞	女 是
㛹	女 便
媓	女 皇
媂	女 帝
媄	女 美
毵	参 毛
矞	矛 LD
𬴃	马 砉
𫘨	马 是
缊	纟 日 皿
缐	纟 泉
骙	马 癸
瑃	王 春
瑓	王 柬
瑅	王 是
瑆	王 星
䴖	青 鸟
瑖	王 段
瑝	王 皇
瑔	王 泉
瑀	王 禹
𤧛	王 帝
瑳	王 差
瑂	王 眉
嶅	敖 山
瑑	王 彖
遘	辶 甘 冉
髢	髟 也
塥	土 鬲
堽	土 罡
赪	赤 贞
摛	扌 离
塝	土 旁
搒	扌 旁
搌	扌 展
蒱	艹 捕
蒨	艹 倩
蓏	艹 瓜 瓜
蔀	艹 部
蓢	艹 朗
蓂	艹 冥
蒻	艹 弱
蓣	艹 预
椹	木 甚
楪	木 世 木
榃	林 田
榅	木 日 皿
楒	木 思
楞	木 四 方
楩	木 便
榇	木 亲
椸	木 施
楙	木 矛 木
歅	西 土 欠
𬪩	酉 农
碃	石 青
碏	石 昔
𬒔	石 肯
碈	石 昏
䃅	石 单
硿	石 空
鄠	雩 阝
辒	车 日 皿
𬨎	车 酋
𫐓	车 柔
龆	齿 召
觜	此 角
䣘	堂 阝
暕	日 柬
鹍	昆
𫫇	口 恶
㬊	日 爰
暅	日 恒
跱	足 寺
蜐	虫 动
蜎	虫 口 月
嵲	山 臬
赗	贝 冒
骱	骨 介
锖	钅 青
𫓹	钅 其
锘	钅 若
锳	钅 英
锧	钅 质
锪	钅 忽
𬭚	钅 享
锫	钅 立 口
锬	钅 炎
𬭛	钅 波
稑	禾 土 八 土
稙	禾 直
䅟	禾 参
𬕂	⺮ 贡
筻	⺮ 更
筼	⺮ 员
筶	⺮ 告
筦	⺮ 完
筤	⺮ 良
傺	亻 祭
鹎	卑 鸟
僇	亻 羽 人 彡
艅	舟 余
艉	舟 尾
谼	谷 共
貆	豸 亘
腽	月 日 皿
腨	月 山 而
腯	月 盾
鲉	鱼 由
鲊	鱼 乍
鲌	鱼 白
䲟	鱼 印
𬶋	鱼 句
𬶍	鱼 它
鲏	鱼 皮
雊	句 隹
猺	犭 爪 缶
飔	风 思
觟	角 圭
𦝼	月 娄
馌	饣 盍
裛	亠 邑 氏
廒	广 敖
瘀	疒 於
瘅	疒 单
鄘	庸 阝
鹒	庚 鸟
鄜	鹿 阝
麀	鹿 匕
鄣	章 阝
阘	门 日 羽
𫔶	门 臬
煁	火 甚
煃	火 奎
煴	火 日 皿
煋	火 星
煟	火 胃
煓	火 耑
滠	氵 聂
溍	氵 晋
溹	氵 索
滆	氵 鬲
滉	氵 晃
溦	氵 山 一 几 攵
溵	氵 殷
漷	氵 郭
滧	氵 效
滘	氵 ⺳ 工 口
滍	氵 蚩
愭	忄 耆
慥	忄 造
慆	忄 舀
塱	朗 土
𫌀	衤 责
裼	衤 易
禋	礻 西 土
禔	礻 是
禘	礻 帝
禒	礻 彖
谫	讠 剪
鹔	肃 鸟
𫖳	君 页
愍	民 攵 心
嫄	女 原
媱	女 爪 缶
戤	盈 戈
勠	羽 人 彡 力
戣	癸 戈
𫘪	马 原
𫘬	马 奚
缞	纟 衰
耤	耒 昔
瑧	王 秦
𫞩	王 𬜯
瑨	王 晋
瑱	王 真
瑷	王 爱
瑢	王 容
斠	甘 冉 斗
摏	扌 舂
墕	土 焉
墈	土 勘
墐	土 堇
墘	土 乾
摴	扌 雩
銎	巩 金
𡐓	土 康
墚	土 梁
撖	扌 敢
𪤗	土 羽 人 彡
靽	革 半
鞁	革 皮
蔌	艹 束 欠
蔈	艹 票
蓰	艹 徙
蔹	艹 敛
蔊	艹 焊
嘏	古 叚
榰	木 耆
榑	木 甫 寸
槚	木 贾
𣗋	木 党
槜	木 隽
榍	木 屑
疐	十 冖 田 疋
𬸘	匚 日 女 鸟
酺	酉 甫
酾	酉 丽
酲	酉 呈
酴	酉 余
碶	石 契
䃎	石 奓
𬒗	石 览
碨	石 畏
𥔲	石 口 口 亏
碹	石 宣
碥	石 扁
劂	厥 刂
𫚖	此 鱼
䴗	目 犬 鸟
夥	果 多
瞍	目 叟
鹖	曷 鸟
㬎	日 幺 幺 灬
跽	足 忌
蜾	虫 果
幖	巾 票
嶍	山 羽 白
圙	囗 八 面
𨱏	钅 艹 合
锺	钅 重
锼	钅 叟
锽	钅 皇
𬭤	钅 侯
锾	钅 爰
锿	钅 哀
镃	钅 兹
镄	钅 费
镅	钅 眉
馝	香 必
鹙	秋 鸟
箨	⺮ 择
箖	⺮ 林
劄	答 刂
僬	亻 焦
僦	亻 就
僔	亻 尊
僎	亻 巽
槃	般 木
㙦	斜 土
鲒	鱼 吉
鲕	鱼 而
𫚕	鱼 师
鲖	鱼 同
鲗	鱼 则
鲘	鱼 后
鲙	鱼 会
𬶐	鱼 兆
𬶏	鱼 危
𩽾	鱼 安
夐	⺈ LD 目 夂
獍	犭 竟
飗	风 留
𬸚	狱 鸟
凘	冫 斯
廑	广 堇
廙	广 田 共
瘗	疒 夹 土
瘥	疒 差
瘕	疒 叚
鲝	羊 鱼
鄫	曾 阝
熇	火 高
漹	氵 焉
漖	氵 教
潆	氵 萦
漤	氵 婪
潩	氵 田 共
漼	氵 崔
漴	氵 崇
㽏	洽 甘
漈	氵 祭
漋	氵 隆
漻	氵 羽 人 彡
慬	忄 堇
窬	穴 俞
窭	穴 娄
㮾	朗 木
𬤝	讠 惠
褕	衤 俞
禛	礻 真
禚	礻 羔
隩	阝 奥
嫕	女 医 心
嫭	女 虍 乎
嫜	女 章
嫪	女 羽 人 彡
𬙂	纟 寅
㻬	王 雩
麹	麦 勹 米
璆	王 羽 人 彡
漦	未 攵 厂 水
叇	云 逮
墣	土 业 羊
墦	土 番
墡	土 善
劐	艹 隹 又 刂
薁	艹 奥
蕰	艹 温
蔃	艹 强
鼒	才 鼎
槱	木 酉 灬
鹝	鬲 鸟
磏	石 兼
磉	石 桑
殣	歹 堇
慭	来 犬 心
霅	雨 言
暵	日 廿 口 夫
暲	日 章
暶	日 旋
踦	足 奇
踣	足 立 口
䗖	虫 带
蝘	虫 匚 日 女
蝲	虫 剌
蝤	虫 酋
噇	口 童
噂	口 尊
噀	口 巽
罶	四 留
嶲	崔 丨 Y 丨 𠃌
嶓	山 番
㠇	山 就
嶟	山 尊
嶒	山 曾
镆	钅 莫
镈	钅 甫 寸
镋	钅 党
镎	钅 拿
𬭩	钅 翁
镕	钅 裕
稹	禾 真
儇	亻 四 一 口 氏
皞	白 皋
皛	白 白 白
䴘	虒 鸟
艎	舟 皇
艏	舟 首
鹟	翁 鸟
𩾃	鱼 免
鲦	鱼 条
鲪	鱼 君
鲬	鱼 甬
橥	猪 木
觭	角 奇
鹠	留 鸟
鹡	脊 鸟
糇	米 侯
糈	米 胥
翦	前 羽
鹢	益 鸟
鹣	兼 鸟
熛	火 票
潖	氵 琶
潵	氵 散
㵐	氵 厥
澂	氵 山 一 王 攵
澛	氵 鲁
瑬	流 玉
潽	氵 普
潾	氵 米 舛
潏	氵 矞
憭	忄 大 丷 日 小
憕	忄 登
𬸣	宀 甘 八 鸟
戭	寅 戈
褯	衤 席
禤	礻 四 羽
𫍽	讠 四 一 口 氏
嫽	女 大 丷 日 小
遹	辶 矞
𬴊	马 米 舛
璥	王 敬
璲	王 遂
璒	王 登
憙	喜 心
擐	扌 四 一 口 氏
鄹	聚 阝
薳	艹 辶 袁
鞔	革 免
黇	黄 占
𬞟	艹 频
蕗	艹 路
薢	艹 解
蕹	艹 雍
橞	木 惠
橑	木 大 丷 日 小
橦	木 童
醑	酉 胥
觱	咸 角
磡	石 勘
𥕢	石 曹
磜	石 祭
豮	豕 贲
𫟦	车 遂
𬺈	齿 奇
𫠜	齿 臼 儿
鹾	卤 差
虤	虎 虎
暿	日 喜
曌	明 空
曈	日 童
㬚	日 育 攵
蹅	足 查
踶	足 是
䗛	虫 脩
螗	虫 唐
疁	田 羽 人 彡
㠓	山 蒙
幪	巾 蒙
𪩘	山 献
嶦	山 詹
𬭬	钅 彗
𨱑	钅 黄
𬭯	钅 敝
馞	香 孛
穄	禾 祭
篚	⺮ 匪
篯	⺮ 钱
簉	⺮ 造
鼽	鼻 九
衠	行 真
盦	今 酉 皿
螣	月 龹 虫
縢	月 龹 糸
鲭	鱼 青
鲯	鱼 其
鲰	鱼 取
鲺	鱼 虱
鲹	鱼 参
𫗴	饣 亶
亸	享 单
癀	疒 黄
瘭	疒 票
𬸦	族 鸟
羱	羊 原
糒	米 EA 丿 LD
燋	火 焦
熻	火 翕
燊	火 火 火 木
燚	炎 炎
燏	火 矞
濩	氵 艹 隹 又
濋	氵 楚
澪	氵 零
澽	氵 虍 豕
澴	氵 四 一 口 氏
澭	氵 雍
澼	氵 辟
憷	忄 楚
憺	忄 詹
懔	忄 禀
黉	VD 冖 黄
嬛	女 四 一 口 氏
鹨	羽 人 彡 鸟
翯	羽 高
𫄷	纟 意
璱	王 瑟
𤩽	王 献
璬	王 敫
璮	王 亶
髽	髟 坐
擿	扌 辶 亠 丷 LD
薿	艹 疑
薸	艹 漂
檑	木 雷
櫆	木 魁
檞	木 解
醨	酉 离
繄	医 殳 糸
磹	石 覃
磻	石 番
瞫	目 覃
瞵	目 米 舛
蹐	足 脊
蟏	虫 萧
㘎	口 门 敢
𬭳	钅 喜
镤	钅 业 羊
𬭶	钅 黑
𫔍	钅 番
镥	钅 鲁
镨	钅 普
𬭸	钅 米 舛
𨱔	钅 尊
𬭼	钅 遂
𫔎	钅 矞
矰	矢 曾
穙	禾 业 羊
穜	禾 童
穟	禾 遂
簕	⺮ 勒
簃	⺮ 移
簏	⺮ 鹿
儦	亻 鹿 灬
魋	鬼 隹
斶	斤 蜀
艚	舟 曹
𬸪	番 鸟
谿	奚 谷
䲠	鱼 春
𬶟	鱼 剌
鲾	鱼 一 口 田
𬶠	鱼 柬
鲿	鱼 尝
鳁	鱼 日 皿
鳂	鱼 畏
鳈	鱼 泉
鳉	鱼 将
獯	犭 熏
䗪	庶 虫
馘	首 或
襕	衤 阑
襚	衤 遂
𬶨	既 鱼
螱	尉 虫
甓	辟 瓦
嬬	女 需
嬥	女 翟
𦈡	纟 需
𫄸	纟 熏
瓀	王 需
釐	未 攵 厘
鬶	规 鬲
爇	艹 土 八 土 丸 灬
鞳	革 艹 合
鞮	革 是
𬟁	艹 鹝
藟	艹 田 田 田
藦	艹 摩
藨	艹 鹿 灬
鹲	蒙 鸟
檫	木 察
黡	厂 犬 黑
礞	石 蒙
礌	石 雷
𥖨	石 品 木
蹢	足 亠 丷 LD
蹜	足 宿
蟫	虫 覃
䗴	虫 ⺮ 廷
嚚	口 口 臣 口 口
髃	骨 禺
镮	钅 四 一 口 氏
镱	钅 意
酂	赞 阝
馧	香 日 皿
簠	⺮ 甫 皿
簝	⺮ 大 丷 日 小
簰	⺮ 牌
鼫	鼠 石
鼩	鼠 句
皦	白 敫
臑	月 需
䲢	月 鲞
鳑	鱼 旁
鳒	鱼 兼
鹱	鸟 艹 隹 又
鹯	亶 鸟
癗	疒 雷
𦒍	童 羽
旞	方 𠂉 遂
翷	米 舛 羽
冁	单 展
䎖	曾 羽
瀔	氵 士 冖 一 禾 殳
瀍	氵 廛
瀌	氵 鹿 灬
襜	衤 詹
䴙	辟 鸟
𬙊	纟 墨
嚭	喜 否
㰀	木 黎
鬷	鬲 凶 八 夂
醭	酉 业 羊
蹯	足 番
蠋	虫 蜀
翾	四 一 口 氏 羽
鳘	敏 鱼
儳	亻 ⺈ 口 比 兔
儴	亻 襄
鼗	兆 鼓
𬶭	鱼 祭
𩾌	鱼 康
鳚	鱼 尉
鳛	鱼 羽 白
麑	鹿 臼 儿
麖	鹿 京
蠃	亡 口 月 虫 凡
彟	寻 艹 隹 又
嬿	女 燕
鬒	髟 真
蘘	艹 襄
欂	木 薄
醵	酉 虍 豕
颥	需 页
甗	虍 鬲 瓦
𨟠	瞿 阝
巇	山 虍 豆 戈
酅	崔 LD 阝
髎	骨 羽 人 彡
犨	隹 隹 牛
𬶮	鱼 喜
𨭉	斌 金
㸌	火 霍
爔	火 羲
瀱	氵 四 厂 炎 刂
瀹	氵 龠
瀼	氵 襄
瀵	氵 米 田 共
襫	衤 奭
孅	女 从 戈 韭
骦	马 霜
𬙋	纟 襄
耰	耒 一 自 心 夂	# 似有误，不影响编码
𤫉	王 燮
瓖	王 襄
鬘	髟 曼
趯	走 翟
𬺓	齿 楚
罍	田 田 田 缶
鼱	鼠 青
鳠	鱼 艹 隹 又
鳡	鱼 感
鳣	鱼 亶
爟	火 艹 口 口 隹
爚	火 龠
灈	氵 瞿
韂	革 詹
糵	薛 米
蘼	艹 靡
礵	石 霜
鹴	霜 鸟
躔	足 廛
皭	白 爵
龢	龠 禾
鳤	鱼 管
亹	亠 臼 同 且
籥	⺮ 龠
鼷	鼠 奚
𫚭	鱼 巛 囗 乂 ZD
玃	犭 矍
醾	酉 糜
齇	鼻 虍 且
觿	角 崔 LD
蠼	虫 矍
