# GBK 中 GB2312 和《规范子表》未收字
〇	J	# 此为符号（非字），暂收着方便输入数字
丂	一 Z
丄	丨 一
丒	刃 一
丗	EA	# 廿之形近
丟	王 厶
丠	北 一
両	一 冂 山	# 冂 交
丣	一 ND 匚 X
並	UA 业
丮	⺄ BI
丯	彡 丨
丳	口 口 ND	# 口 交
丵	业 半
丼	井 丶
乀	S	AAA	#** 捺，应算作点
乁	YDA	AAA	# YDA 之形近
乄	丿 丶	# 撇 点 交
乆	Z 人
乊	丿 丷
乕	⺁ 二 巾	# 二 交
乗	禾 EA		# 禾 交；异于“乘”
乢	山 乚
乣	幺 乚
乤	下 乙
乥	乊 乙
乧	斗 乙
乨	台 乚
乪	乙 田
乫	加 乙
乬	巨 乙
乭	石 乙
乮	卯 乙
乯	乎 乙
乲	次 乙
乴	折 乙
乵	辛 乚
乶	甫 乙
乷	沙 乙
乹	龺 乚
乺	所 乙
乻	於 乙
乼	注 乙
乽	者 乙
乿	爪 糸 乚
亀	⺈ 日 电		# 日 交
亁	十 日 干 乞
亂	爪 龴 LD 乚	# 特殊
亃	粦 乚
亄	壹 乚
亇	⺈ 亅
亊	D 丷 彐		# D 交
亐	一 一 Z		#** 特殊：单拆一；一 交
亖	二 二
亗	山 二
亙	二 RS	# 夕之形近
亜	二 口 刂	# 二 口 交
亝	厽 二
亞	BZ
亣	亠 ND
亪	亦 乁
亯	亠 口 日
亰	亠 日 小
亱	亠 但
亴	亠 口 冖 土 九
亷	立 丿 XK
亼	人 一
亽	人 丶
亾	Z 人
仈	亻 八
仌	人 人
仏	亻 厶
仐	人 十
仒	人 TD
仚	人 山
仛	亻 乇
仜	亻 工
仠	亻 干
仢	亻 勺
仦	亻 小
仧	上 人
仩	亻 上
仭	亻 刃
仮	亻 反
仯	亻 少
仱	亻 今
仴	亻 月
仸	亻 夭
仹	亻 丰
仺	人 H	# 匚之形近
仼	亻 王
仾	亻 互
伀	亻 公
伂	亻 巿
伃	亻 予
伄	亻 弔
伅	亻 屯
伆	亻 勿
伇	亻 殳
伌	亻 厄
伒	亻 斤
伓	亻 不
伔	亻 冗
伕	亻 夫
伖	亻 友
伜	亻 卆
伝	亻 云
伡	亻 车
伨	亻 匀
伩	亻 文
伬	亻 尺
伮	亻 奴
伱	亻 尒
伳	亻 世
伵	亻 四
伷	亻 由
伹	亻 且
伻	亻 平
伿	亻 只
佀	亻 Y
佂	亻 正
佄	亻 甘
佅	亻 未
佇	亻 宁
佈	亻 布
佉	亻 去
佊	亻 皮
佋	亻 召
佌	亻 此
佒	亻 央
佔	亻 占
佡	亻 仚
佢	亻 巨
佦	亻 石
佨	亻 包
佪	亻 回
佫	亻 各
佭	亻 夅
佮	亻 合
佱	人 二 止	# 特殊
佲	亻 名
併	亻 并
佷	亻 艮
佹	亻 危
侀	亻 刑
侅	亻 亥
來	木 人 人
侇	亻 夷
侊	亻 光
侌	今 云
侎	亻 米
侐	亻 血
侒	亻 安
侓	亻 聿
侕	亻 而
侖	亼 LD
侙	亻 式
侚	亻 旬
侜	亻 舟
侞	亻 如
侟	亻 存
価	亻 西
侢	亻 再
侤	亻 考
侫	亻 妄
侭	亻 尽
侰	亻 君
侱	亻 呈
侲	亻 辰
侳	亻 坐
侶	亻 呂
侷	亻 局
侸	亻 豆
侺	亻 岑
侻	亻 兑
侼	亻 孛
侽	亻 男
侾	亻 孝
俀	亻 妥
俁	亻 吳
係	亻 系
俆	亻 余
俇	亻 狂
俈	亻 告
俉	亻 吾
俋	亻 邑
俌	亻 甫
俒	亻 完
俓	亻 巠
俔	亻 見
俕	亻 宋
俖	亻 否
俛	亻 免
俠	亻 夾
俢	亻 夂 彡	# 修少一竖
俤	亻 弟
俥	亻 車
俧	亻 志
俬	亻 私
俰	亻 和
俲	亻 効
俴	亻 戔
俷	亻 肥
俹	亻 亞
俻	亻 备
俼	亻 育
俽	亻 欣
俿	亻 虎
倀	亻 長
倁	亻 和
倂	亻 幷	# 非“併”
倃	亻 咎
倄	亻 肴
倅	亻 卒
倆	亻 兩
倇	亻 宛
倈	亻 來
倉	亽 XM 口	# 尸之形近
倊	亻 忩
個	亻 固
倎	亻 典
倐	亻 丨 夂 火
們	亻 門
倖	亻 幸
倗	亻 朋
倛	亻 其
倝	龺 人
倠	亻 隹
倢	亻 疌
倣	亻 放
値	亻 十 目 Z	# 异于“值”
倫	亻 侖
倯	亻 松
倰	亻 夌
倱	亻 昆
倲	亻 東
倳	亻 事
倵	亻 武
倶	亻 目 一 八	# 异于“俱”
倷	亻 奈
倸	亻 采
倹	亻 亼 口 人	# 口 交
倽	亻 舍
倿	亻 妾
偀	亻 英
偂	亻 前
偄	亻 耎
偅	亻 重
偆	亻 春
偉	亻 韋
偊	亻 禹
偋	亻 屏
偍	亻 是
偐	亻 彦
偑	亻 QI
偒	亻 昜
偔	亻 咢
偖	亻 者
偗	亻 省
偘	亻 品
偙	亻 帝
偛	亻 臿
偝	亻 背
偞	亻 枼
偟	亻 皇
偠	亻 要
偢	亻 秋
偣	亻 音
偤	亻 酋
偦	亻 胥
偧	亻 奓
偨	亻 柴
偩	亻 負
偪	亻 畐
偫	亻 待
偮	亻 咠
偯	亻 哀
偱	亻 盾
偳	亻 耑
側	亻 則
偵	亻 貞
偸	亻 兪
偹	亻 丨 备
偺	亻 昝
偼	亻 卜 彐 止
偽	亻 為
傁	亻 叟
傂	亻 虒
傄	亻 眘
傆	亻 原
傇	亻 茸
傊	亻 員
傋	亻 冓
傌	亻 馬
傎	亻 真
傏	亻 唐
傐	亻 高
傑	亻 桀
傓	亻 扇
傔	亻 兼
傖	亻 倉
傗	亻 畜
傘	人 仌 仌 十
備	亻 廿 丿 LD
傚	亻 效
傛	亻 容
傜	亻 爪 缶
傝	亻 日 羽
傞	亻 差
傟	亻 翁
傠	亻 討
傡	亻 竝
傢	亻 家
傤	亻 载
傦	亻 骨
傪	亻 參
傫	亻 累
傭	亻 庸
傮	亻 曹
傯	亻 悤
傰	亻 崩
傱	亻 從
傳	亻 專
傴	亻 區
債	亻 責
傶	亻 戚
傷	亻 𠂉 昜
傸	亻 爽
傹	亻 竟
傼	亻 廿 口 夫	# 口 交
傽	亻 章
傾	亻 頃
傿	亻 焉
僀	亻 帶
僁	亻 悉
僂	亻 婁
僃	亻 艹 勹 LD
僄	亻 票
僅	亻 堇
僆	亻 連
僈	亻 曼
僉	亼 吅 从
僊	亻 西 大 巳
僋	亻 貪
僌	亻 車 攵
働	亻 動
僐	亻 善
僑	亻 喬
僒	亻 窘
僓	亻 貴
僕	亻 菐
僗	亻 勞
僘	亻 敞
僙	亻 黄
僛	亻 欺
僜	亻 登
僝	亻 孱
僞	亻 爲
僟	亻 幾
僠	亻 番
僡	亻 惠
僢	亻 舜
僣	亻 替
僤	亻 單
僥	亻 堯
僨	亻 賁
僩	亻 閒
僪	亻 矞
僫	亻 惡
僯	亻 粦
僱	亻 雇
僲	亻 西 舛
僴	亻 間
僶	亻 黽
僷	亻 葉
僸	亻 禁
價	亻 賈
僺	亻 喿
僼	亻 豊
僽	亻 愁
僾	亻 愛
僿	亻 塞
儀	亻 UC 我
儁	亻 雋
儂	亻 農
儃	亻 亶
億	亻 意
儅	亻 當
儈	亻 會
儉	亻 僉
儊	亻 楚
儌	亻 敫
儍	亻 OS 凵 八 夂
儎	亻 載
儏	亻 粲
儐	亻 賓
儑	亻 㬎
儓	亻 臺
儔	亻 壽
儕	亻 齊
儖	亻 監
儗	亻 疑
儘	亻 盡
儙	亻 遣
儚	亻 夢
儛	亻 舞
儜	亻 寧
儝	亻 榮
儞	亻 爾
償	亻 賞
儠	亻 巤
儢	亻 慮
儣	亻 廣
儤	亻 暴
儥	亻 賣
儧	亻 賛
儨	亻 質
儩	亻 賜
優	亻 憂
儫	亻 豪
儬	亻 靚
儭	亻 親
儮	亻 歷
儯	亻 駦
儰	亻 蔿
儱	亻 龍
儲	亻 諸
儵	亻 丨 夂 黑
儶	亻 巂
儷	亻 麗
儸	亻 羅
儹	亻 贊
儺	亻 難
儻	亻 黨
儼	亻 嚴
儽	亻 纍
儾	亻 囊
兂	匚 儿	# 匚 交
兇	凶 儿
兊	公 儿
兌	八 兄	# 异于“兑”
兎	丿 口 儿 丶	# 口 交
兏	厂 卜 兀	# 从厂不从⺁
児	旧 儿
兒	臼 儿
兓	兂 兂
兗	六 兄
兘	元 台
兙	克 十
兛	克 千
兝	克 分
兞	克 毛
兟	先 先
兠	丬 白 匕 儿	# 不合笔顺
兡	克 百
兣	克 厘
兤	光 廣
兦	Z 入
內	冂 入	# 冂 交
兩	一 冂 丨 入 入	# 冂 交
兪	亼 月 ZD	# 异于“俞”
兯	丷 Y
兲	王 八
兺	分 叱
兾	丷 異
兿	UA 执 云
冃	冂 二
冄	冂 二	# 冂 交
円	冂 丄
冇	𠂇 冂
冊	冂 艹	# 冂 交；异于“册”
冋	冂 口
冎	LD 冂
冐	日 月
冑	由 月
冓	甘 冉
冘	冖 儿	# 冖 交
冚	冖 山
冝	冖 且
冞	冖 米
冟	冖 皀
冡	冖 一 豕
冣	冖 取
冦	冖 元 攴
冧	冖 林
冨	冖 畐
冩	冖 舄
冪	冖 幕
冭	大 TD
冴	冫 牙
冸	冫 半
冹	冫 犮
冺	冫 民
冾	冫 合
冿	冫 聿
凁	冫 束
凂	冫 免
凃	冫 余
凅	冫 固
凈	冫 爭
凊	冫 青
凍	冫 東
凎	冫 金
凐	冫 垔
凒	冫 豈
凔	冫 倉
凕	冫 冥
凖	准 十
凗	冫 崔
凙	冫 睪
凚	冫 禁
凜	冫 稟
凞	冫 熈
凟	冫 賣
凢	丿 几
凣	丨 几
凥	尸 几
処	夂 几
凧	几 巾
凨	几 云
凩	几 木
凪	几 止
凬	几 一 日
凮	几 百
凱	豈 几
凲	几 兼
凴	馮 几
凷	土 凵
凾	了 口 又 凵
刄	刀 丶	# 异于“刃”；点 交
刅	刀 八
刉	乞 刂
刋	丿 𠂇 刂
刌	寸 刂
刏	气 刂
刐	丹 刂	# Q 交
刓	元 刂
刔	夬 刂
刕	刀 刀 刀
刜	弗 刂
刞	且 刂
刟	召 刂
刡	民 刂
刢	令 刂
刣	台 刂
別	口 力 刂	# 异于“别”
刦	去 刂
刧	去 刀
刪	冊 刂	# 异于“删”
刯	亘 刂
刱	井 刅
刲	圭 刂
刴	朶 刂
刵	耳 时
刼	去 刃
刾	夹 刂
剄	巠 刂
剆	丶 艮 刂
則	貝 刂
剈	肙 刂
剉	坐 刂
剎	乂 术 刂	# 异于“刹”
剏	并 刃
剒	昔 刂
剓	禾 勹 丿 刀
剗	戔 刂
剘	其 刂
剙	并 刅
剚	事 刂
剛	LD 刂
剝	彔 刂
剠	京 刂
剢	豖 刂
剣	亼 口 人 刂	# 口 交
剤	文 ND 刂
剦	奄 刂
剨	砉 刂
剫	度 刂
剬	耑 刂
剭	屋 刂
剮	咼 刂
剰	乗 刂
剱	亼 口 人 刃	# 口 交
剳	荅 刂
剴	豈 刂
創	倉 刂
剶	彖 刂
剷	産 刂
剸	專 刂
剹	翏 刂
剺	未 攵 厂 刀
剻	崩 刂
剼	參 刂
剾	區 刂
劀	矞 刂
劃	畫 刂
劅	蜀 刂
劆	廉 刂
劇	豦 刂
劉	RH 丶 刀 金 刂
劊	會 刂
劋	喿 刂
劌	歲 刂
劍	僉 刂
劎	僉 刀
劏	當 刂
劑	齊 刂
劒	僉 刃
劔	僉 刄
劕	質 刂
劖	毚 刂
劗	贊 刂
劘	靡 刂
劙	蠡 刂
劚	屬 刂
劜	力 乚
劤	斤 力
劥	亢 力
劦	力 力 力
劧	手 力
劮	失 力
劯	石 力
劰	白 力
労	VD 冖 力
劵	龹 力
劶	后 力
劷	羊 力
劸	圭 力
効	交 力
劺	牟 力
劻	匡 力
劽	列 力
勀	克 力
勁	巠 力
勂	告 力
勄	每 力
勅	束 力
勆	丶 艮 力
勈	甬 力
勊	克 力
勌	卷 力
勎	坴 力
勏	咅 力
勑	來 力
勓	皆 力
動	重 力
勗	日 助
務	矛 务
勛	員 力
勜	翁 力
勝	月 劵	# 从力不从刀
勞	𤇾 力
勡	票 力
勢	埶 力
勣	責 力
勥	强 力
勦	巢 力
勧	𠂉 一 隹 力
勨	象 力
勩	貰 力
勪	喬 力
勫	番 力
勬	絭 力
勭	童 力
勮	豦 力
勯	亶 力
勱	萬 力
勲	動 灬
勳	熏 力
勴	慮 力
勵	厲 力
勶	徹 力
勷	襄 力
勸	雚 力
勻	勹 二	# 异于“匀”
勼	勹 九
勽	勹 人
匁	勹 丿 丶
匂	勹 匕
匃	RY	AAA
匄	勹 亡
匇	勹 夕
匉	勹 平
匊	勹 米
匋	勹 缶
匌	勹 合
匎	勹 奄
匑	勹 躬
匒	勹 荅
匓	勹 艮 殳
匔	勹 躳
匘	匕 巛 囟
匛	匚 久
匞	匚 工
匟	匚 亢
匢	匚 勿
匤	匚 玉
匥	匚 弁
匧	匚 夾
匨	匚 壯
匩	匚 屮 王	# 中为“屮”非“山”
匫	匚 勿 日
匬	匚 俞
匭	匚 軌
匯	匚 淮
匰	匚 單
匱	匚 貴
匲	匚 大 品
匳	匚 僉
匴	匚 算
匵	匚 賣
匶	匚 舊
匷	匚 瞿
匸	H	AAA
匽	匚 日 女
區	匚 品
卂	⺄ 十
卄	E	AAA
卆	九 十
卋	十 廿
卌	E	AAA
卍	Y 丨 一 丨	# 折 交
卐	Z 一 丨 一	# 折 交
協	十 劦
単	VD 日 十	# 日 交
卙	甚 十
卛	龻 十
卥	卜 囗 OD S	# OD 交 
卨	卜 咼
卪	卩 丶
卭	工 卩
卲	召 卩
卶	多 卩
卹	血 卩
卻	谷 卩
卼	兀 危
卽	皀 卩
卾	咢 卩
厀	桼 卩
厁	斜 Y
厃	⺈ 厂
厇	厂 乇
厈	厂 干
厊	厂 牙
厎	厂 氐
厏	厂 乍
厐	厂 龙
厑	厂 叱
厒	厂 缶
厓	厂 圭
厔	厂 至
厗	厂 辛
厙	厂 車
厛	厂 听
厜	厂 垂
厞	厂 非
厠	厂 則
厡	厂 泉
厤	厂 禾 禾
厧	厂 真
厪	厂 堇
厫	厂 敖
厬	厂 晷
厭	厂 猒
厯	厂 林 Z 丶 丶	# 特殊，下非“心”
厰	厂 敞
厱	厂 僉
厲	厂 萬
厳	VD 厂 敢
厴	厭 甲
厵	原 原 原
厷	𠂇 厶
厸	厶 厶
厹	九 厶
厺	大 厶
厼	厶 小
厽	厶 厶 厶
叀	一 由 厶
參	厽 人 彡
叄	厽 人 三
叅	厽 人 ⺗
収	丩 又
叏	X 又
叐	丿 友
叒	又 双
叓	一 中 又
叜	灾 又
叝	去 卩 又
叞	尸 示 又
叡	睿 又
叢	丵 取
叧	口 刀
叴	九 口
叺	口 入
叾	了 口
叿	口 工
吀	口 千
吂	亡 口
吅	口 口
吇	口 子
吋	口 寸
吔	口 也
吘	口 午
吙	口 火
吚	口 尹
吜	口 丑
吢	心 口
吤	口 介
吥	口 不
吪	口 化
吰	口 厷
吳	口 Z 大	# 异于“吴呉”
吶	口 內	# 异于“呐”
吷	口 夬
吺	口 殳
吿	牛 口	# 异于“告”
呁	口 匀
呂	口 NJ	# 异于“吕”
呄	乃 古
呅	口 文
呉	口 Z 一 八	# 异于“吴吳”
呌	口 斗
呍	口 云
呎	口 尺
呏	口 升
呑	夭 口	# 异于“吞”
呚	口 攵
呝	口 戹
呞	口 司
呟	口 玄
呠	口 本
呡	口 民
呥	口 冉
呧	口 氐
呩	口 示
呪	口 兄
呫	口 占
呬	口 四
呭	口 世
呮	口 只
呯	口 平
呰	此 口
呴	口 句
呹	口 失
呺	口 号
呾	口 旦
呿	口 去
咁	口 甘
咃	口 他
咅	立 口
咈	口 弗
咊	口 禾
咑	口 打
咓	口 瓦
咗	口 左
咘	口 布
咜	口 它
咞	口 开
咟	口 百
咠	口 耳
咢	吅 亏
咮	口 朱
咰	口 旬
咲	口 关
咵	口 夸
咶	口 舌
咷	口 兆
咹	口 安
咼	LJ	AAA
咾	口 老
哅	口 匈
哊	口 有
哋	口 地
哖	口 年
哘	口 行
哛	叱 分
哠	口 告
員	口 貝
哣	口 豆
哤	口 尨
哫	口 足
哬	口 何
哯	口 見
哰	口 牢
哴	口 良
哵	口 别
哶	口 卝 干
哷	口 寽
哸	口 妥
哹	口 孚
哻	口 旱
哾	口 兑
唀	口 秀
唂	口 谷
唃	口 角
唄	口 貝
唅	口 含
唈	口 邑
唊	口 夾
唋	口 余
唌	口 延
唍	口 远
唎	口 利
唒	口 酉
唓	口 車
唕	口 皁
唖	口 亜
唗	口 走
唘	石 又 口
唙	口 狄
唚	口 彐 冖 又
唜	末 叱
唞	口 抖
唟	去 叱
唡	口 两
唥	口 冷
唦	口 沙
唨	口 阻
唩	口 委
唫	口 金
唭	口 其
唲	口 兒
唴	口 羌
唶	口 昔
唸	口 念
唹	口 於
唺	口 典
唻	口 來
唽	口 析
啀	口 厓
啂	口 乳
啅	口 卓
啇	亠 丷 LD
啈	口 幸
啋	口 采
啌	口 空
啍	口 享
啎	午 吾
問	門 口
啑	口 疌
啒	口 屈
啓	户 攵 口
啔	户 戈 口
啗	口 臽
啘	口 宛
啙	此 吅
啚	口 十 回
啛	口 妻
啝	口 和
啞	口 亞
啟	启 攵
啠	斦 口
啢	口 兩
啣	口 卸
啨	口 青
啩	口 卦
啯	口 国
啱	口 岩
啲	口 的
啳	口 卷
啹	口 居
啺	口 昜
啽	口 弇
啿	口 甚
喅	口 昱
喌	吅 州
喍	口 柴
喎	口 咼
喐	口 郁
喒	口 昝
喓	口 要
喕	口 面
喖	口 枯
喗	口 軍
喚	口 奐
喛	口 爰
喞	口 卽	# 异于“唧”
喠	口 重
喡	口 韋
喢	口 臿
喣	呴 灬
喥	口 度
喦	品 山
喨	口 亮
喩	口 兪	# 异于“喻”
喪	十 口 口 H
喫	口 契
喬	夭 口 LD
喭	口 彦
單	吅 日 十	# 日 交
喯	口 奔
喰	口 食
喲	口 約
喴	口 威
営	VD 冖 吕
喸	甫 叱
喺	口 係
喼	口 急
喿	品 木
嗀	士 冖 一 口 殳
嗁	口 虒
嗂	口 爪 缶
嗃	口 高
嗆	口 倉
嗇	土 人 人 回
嗈	口 邕
嗊	口 貢
嗋	口 脅
嗎	口 馬
嗏	口 茶
嗕	口 辱
嗗	口 骨
嗘	口 奚
嗙	口 旁
嗚	口 烏
嗛	口 兼
嗠	孚 各
嗢	口 昷
嗧	加 侖
嗩	口 小 貝
嗭	直 叱
嗮	口 晒
嗰	口 個
嗱	口 拿
嗴	口 羗
嗶	口 畢
嗸	敖 口
嗹	口 連
嗺	口 崔
嗻	口 庶
嗼	口 莫
嗿	口 貪
嘂	吕 丩 吕
嘃	口 庸
嘄	口 梟
嘅	口 既
嘆	口 廿 口 夫	# 口 交
嘇	口 參
嘊	口 崖
嘋	口 教
嘍	口 婁
嘐	口 翏
嘑	口 虖
嘒	口 彗
嘓	口 國
嘔	口 區
嘕	口 焉
嘖	口 責
嘗	龸 口 旨
嘙	口 婆
嘜	口 麥
嘝	口 斛
嘠	口 戞
嘢	口 野
嘥	口 徙
嘦	只 要
嘨	口 粛
嘩	口 華
嘪	口 買
嘫	口 然
嘮	口 勞
嘯	口 肅
嘰	口 幾
嘳	口 貴
嘵	口 堯
嘷	口 臯
嘸	口 無
嘺	口 喬
嘼	吅 田 一 口
嘽	口 單
嘾	口 覃
噁	口 惡
噃	口 番
噄	口 絜
噅	口 爲
噆	口 朁
噈	口 就
噉	口 敢
噊	口 矞
噋	口 敦
噏	口 翕
噐	吅 工 吅
噑	口 皐
噒	口 粦
噓	口 虛
噕	爲 口
噖	口 琴
噚	口 尋
噛	口 歯
噝	口 絲
噞	口 僉
噟	广 亻 隹 口
噠	口 達
噡	口 詹
噣	口 蜀
噥	口 農
噦	口 歲
噧	口 萬
噭	口 敫
噮	口 睘
噯	口 愛
噰	口 雍
噲	口 會
噳	口 虞
噴	口 賁
噵	道 口
噷	口 歆
噸	口 頓
噹	口 當
噺	口 新
噽	喜 丕
噾	口 窨
噿	口 翠
嚀	口 寧
嚁	口 翟
嚂	口 監
嚃	口 遝
嚇	口 赫
嚈	口 厭
嚉	口 對
嚊	口 鼻
嚋	口 壽
嚌	口 齊
嚍	口 盡
嚐	口 嘗
嚑	口 熏
嚒	口 麼
嚔	口 十 冖 田 厶 止
嚕	口 魯
嚖	口 慧
嚗	口 暴
嚘	口 憂
嚙	口 齒
嚛	口 樂
嚜	口 墨
嚝	口 廣
嚞	吉 喆
嚟	口 黎
嚠	口 劉
嚡	口 鞋
嚢	一 中 ⺳ 甘 氏
嚤	口 摩
嚥	口 燕
嚦	口 歷
嚧	口 盧
嚨	口 龍
嚩	口 縛
嚪	口 閻
嚫	口 親
嚬	口 頻
嚮	鄉 向
嚰	口 磨
嚱	口 戲
嚲	享 單
嚳	臼 爻 告
嚴	吅 厂 敢
嚵	口 毚
嚶	口 嬰
嚸	口 點
嚹	口 罅
嚺	口 辶 四 UD 豕
嚻	吕 頁 吕
嚽	口 贅
嚾	口 雚
嚿	口 舊
囀	口 轉
囁	口 聶
囂	吅 頁 吅
囃	口 雜
囄	口 離
囅	單 展
囆	口 蠆
囇	口 麗
囈	口 藝
囉	口 羅
囋	口 贊
囌	口 蘇
囍	喜 喜
囎	口 贈
囏	廿 口 夫 喜
囐	口 獻
囑	口 屬
囒	口 蘭
囓	口 齧
囕	口 覽
囖	口 籮
囘	冂 巳
囙	囗 X
囜	囗 厶
団	囗 寸
囥	囗 亢
囦	囗 水
囧	囗 八 冂
囨	囗 不
囩	囗 云
囪	NJ OD 丶
囬	囗 KD
囮	囗 化
囯	囗 王
囲	囗 井
図	囗 TD 乂	# 冫之形近（二点）
囶	囗 八 土
囸	囗 正
囻	囗 民
囼	囗 台
圀	囗 八 方
圁	囗 言
圂	囗 豕
圅	龴 囗 半
圇	囗 侖
國	囗 或
圍	囗 韋
圎	囗 厶 貝
圏	囗 巻
圑	囗 尃
園	囗 袁
圓	囗 員
圔	囗 盍
圕	囗 書
圖	囗 啚
圗	囗 厶 面
團	囗 專
圚	囗 貴
圛	囗 睪
圝	囗 龻
圞	囗 欒
圠	土 乚
圡	土 丶
圤	土 卜
圥	土 儿
圦	土 入
圧	厂 土
圱	丿 𠂇 土
圴	土 勺
圵	土 上
圶	大 土
圷	土 下
圸	土 山
圼	日 土
圽	土 勿
圿	土 介
坁	土 氏
坃	土 元
坄	土 殳
坅	土 今
坆	土 攵
坈	土 冗
坓	井 土
坔	水 土
坕	爪 土
坖	元 土
坘	土 互
坙	HD 土	# 非“巠”
坢	土 半
坣	龸 土
坧	土 石
坮	土 台
坱	土 央
坲	土 弗
坴	土 八 土
坵	土 丘
坸	土 句
坹	土 穴
坺	土 犮
坾	土 宁
坿	土 付
垀	土 乎
垁	土 矢
垇	土 凹
垉	土 包
垊	土 民
垐	次 土
垑	土 多
垔	西 土
垖	土 丿 Y
垗	土 兆
垘	土 伏
垜	土 朶
垝	土 危
垥	土 合
垨	土 守
垪	土 并
垬	土 共
垰	土 卜 二 卜	# 不是“上 下”
垳	土 行
垶	土 辛
垷	土 見
垹	土 邦
垻	土 貝
垼	役 土
垽	沂 土
埀	千 北 二	# 千 交
埁	土 岑
埄	土 夆
埅	防 土
埈	土 夋
埉	土 夾
埊	山 水 土
埍	土 肙
埐	土 彐 冖 又
埑	折 土
埓	土 PV 寸	# 特殊：异于“埒”
埖	土 花
埛	土 LD
埜	林 土
埞	土 定
埡	土 亞
埢	土 卷
埣	土 卒
埥	土 青
埦	土 宛
埧	土 具
埨	土 侖
埩	土 争
埬	土 東
埮	土 炎
埰	土 采
埱	土 叔
埲	土 奉
埳	土 臽
埶	坴 丸
執	幸 丸
埻	土 享
埾	取 土
埿	泥 土
堁	土 果
堄	土 兒
堅	臤 土
堈	土 LD
堊	亞 土
堏	枋 土
堒	土 昆
堓	土 岸
堔	土 罙
堖	土 巛 囟
堗	土 突
堘	土 龹 土
堚	土 軍
堛	土 畐
堜	土 柬
堝	土 咼
堟	土 彖
堢	土 保
堣	土 禺
堥	敄 土
堦	土 皆
堩	土 恒	# 从“恒”不从“恆”
堫	土 凶 八 夂
堬	土 俞
堭	土 皇
堮	土 咢
堯	垚 兀
報	幸 卩 又
堳	土 眉
場	土 昜
堶	土 左 月
堷	土 音
堸	土 QI
堹	土 重
堺	土 界
堻	津 土
堿	土 咸
塀	土 屏
塁	田 V 土
塂	土 巷
塃	土 荒
塇	土 宣
塈	既 土
塉	土 脊
塊	土 鬼
塋	𤇾 土
塎	土 容
塏	土 豈
塐	土 素
塒	土 時
塓	土 冥
塕	土 翁
塖	土 乘
塗	涂 土
塙	土 高
塚	土 冢
塛	土 栗
塜	土 冡
塟	艹 死 土
塠	土 追
塡	土 眞
塢	土 RZA
塣	浧 土
塤	土 員
塦	陣 土
塧	土 益
塨	土 恭
塩	土 𠂉 口 皿
塪	土 舀
塭	土 昷
塮	土 射
塯	土 留
塰	海 土
塲	土 𠂉 昜
塳	土 逢
塴	土 崩
塵	鹿 土
塶	土 鹿
塷	土 鹵
塸	土 區
塹	斬 土
塺	广 林 土
塻	土 莫
塼	土 專
塽	土 爽
塿	土 婁
墂	土 票
墄	土 戚
墆	土 帶
墇	土 章
墊	執 土
墋	土 參
墌	土 庶
墍	旣 土
墎	土 郭
墏	將 土
墑	土 啇
墔	土 崔
墖	土 畣
増	土 曽
墛	土 尉
墜	隊 土
墝	土 堯
墠	土 單
墢	土 發
墤	土 貴
墥	土 童
墧	土 喬
墪	敦 土
墫	土 尊
墬	阝 彖 土
墭	土 盛
墮	隋 土
墯	惰 土
墰	土 覃
墱	土 登
墲	土 無
墳	土 賁
墴	土 黄
墵	土 雲
墶	土 達
墷	土 華
墸	土 著
墹	土 間
墺	土 奥
墻	土 嗇
墽	土 敫
墾	貇 土
墿	土 睪
壀	土 辟
壂	殿 土
壃	土 畺
壄	楙 土
壆	臼 爻 土
壇	土 亶
壈	土 稟
壉	土 豦
壊	土 十 四 衣	# 非“壞”
壋	土 當
壌	土 六 甘 氏
壍	漸 土
壎	土 熏
壏	土 監
壐	爾 土
壒	土 蓋
壓	厭 土
壔	土 壽
壖	土 需
壗	土 盡
壘	畾 土
壙	土 廣
壚	土 盧
壛	土 閻
壜	土 曇
壝	土 遺
壞	土 褱
壟	龍 土
壠	土 龍
壡	睿 圣
壢	土 歷
壣	土 聯
壥	土 厂 墨
壦	土 雚
壧	土 嚴
壨	田 田 田 田 土
壩	土 霸
壪	土 彎
壭	士 Y
壯	爿 士
壱	士 冖 匕
売	士 冖 儿	# 异于“壳”
壴	吉 UA
壵	士 士 士
壷	士 冖 口 KD 一	# 口 交
壺	士 冖 丨 一 Z Z 一 丨 一	# 非“壼”
壻	土 胥
壼	士 冖 亞
壽	士 乛 工 一 口 寸
壾	壴 巨
壿	士 尊	# 从士不从土
夀	BI 乛 口 一 口 寸	# 特殊；BI 交
夁	士 四 固
夃	乃 又
夅	夂 牛
夆	夂 丰
夈	夂 米
変	SK 夂
夊	RS	AAA
夋	厶 八 夂
夌	土 八 夂
夎	坐 夂
夑	火 言 火 夂
夒	一 止 自 巳 八 夂
夓	臼 一 自 八 夂
夗	夕 ⺋
夘	夕 卩
夛	彐 夕
夝	夕 生
夞	外 叱
夠	多 句
夡	多 吉
夢	艹 四 冖 夕
夣	亠 厶 四 冖 夕
夦	甚 多
夨	一 Z 丶	# 特殊：Z 交
夰	大 ND
夲	大 十
夳	大 二
夵	大 小
夶	大 大
夻	大 口
夽	大 云
夾	大 人 人
夿	大 巴
奀	不 大
奃	大 氐
奅	大 卯
奆	大 巨
奊	圭 夨	# 特殊
奌	占 大
奍	龹 ND
奐	⺈ LD 大	# 异于“奂”
奒	大 亥
奙	厶 奄
奛	大 明
奜	非 大
奝	大 周
奞	大 隹
奟	大 朋
奣	天 明
奤	大 面
奦	務 大
奧	NL 釆 大	# 非“奥”
奨	丬 爪 寸 大	# 特殊：上非“将”
奩	大 區
奪	奞 寸
奫	大 淵
奬	將 大
奮	奞 田
奯	大 歲
奰	四 四 四 大
奱	龻 大
奲	奢 單
奵	女 丁
奷	女 千
奺	女 久
奻	女 女
奼	女 乇
奾	女 山
奿	丸 女
妀	己 女
妅	女 工
妉	女 冘
妋	女 夫
妌	女 井
妎	女 介
妏	女 文
妐	女 公
妑	女 巴
妔	女 亢
妕	女 中
妚	女 不
妛	屮 一 女	# 上从屮不从山
妜	女 夬
妝	爿 女
妟	日 女
妠	女 内
妡	女 斤
妢	女 分
妦	女 丰
妬	女 石
妰	女 乍
妱	女 召
妳	女 尔
妴	夗 女
妵	女 主
妶	女 玄
妷	女 失
妸	女 可
妺	女 末
妼	女 必
妽	女 申
妿	加 女
姀	女 禾
姁	女 句
姂	女 乏
姃	女 正
姄	女 民
姅	女 半
姇	付 女
姉	女 巿	# 从巿不从市
姌	女 冉
姍	女 冊	# 异于“姗”
姎	女 央
姏	女 甘
姕	此 女
姖	女 巨
姙	女 任
姛	女 同
姟	女 亥
姠	女 向
姡	女 舌
姢	女 厶 月
姦	女 女 女
姧	女 女 干
姩	女 年
姪	女 至
姫	女 臣
姭	劦 女
姯	女 光
姰	女 旬
姲	女 安
姳	女 名
姴	列 女
姵	女 QD 帀
姷	女 有
姸	女 幵	# 异于“妍”
姺	女 先
姼	女 多
姾	女 全
娂	女 共
娊	女 見
娋	女 肖
娍	女 成
娎	折 女
娏	女 尨
娐	女 孚
娒	女 每
娔	女 克
娕	女 束
娖	女 足
娗	女 廷
娙	女 巠
娚	女 男
娛	女 吳	# 异于“娱娯”
娝	女 否
娞	女 妥
娡	女 志
娢	女 含
娤	壯 女
娦	女 兵
娧	女 兑
娨	女 旱
娪	女 吾
娫	女 延
娬	女 武
娭	女 矣
娮	女 言
娯	女 呉	# 异于“娱娛”
娰	女 似
娳	女 利
娷	女 垂
娸	女 其
娹	女 弦
娺	女 叕
娻	女 東
娽	女 录
娾	女 厓
娿	阿 女
婁	KJ 女
婂	女 帛
婃	女 宗
婄	女 咅
婅	女 匊
婇	女 采
婈	女 夌
婋	女 虎
婎	女 隹
婏	女 兔
婐	女 果
婑	女 委
婒	女 炎
婓	非 女
婔	女 非
婖	女 忝
婗	女 兒
婙	女 争
婛	女 京
婜	臤 女
婝	女 定
婟	女 固
婡	女 來
婣	女 ND
婥	女 卓
婦	女 帚
婨	女 侖
婩	女 岸
婬	女 爪 壬
婭	女 亞
婮	女 居
婯	一 LD 一 LD 女
婰	女 典
婱	弦 女
婲	女 花
婸	女 昜
婹	女 要
婽	女 叚
婾	女 兪
媀	女 禺
媁	女 韋
媃	女 柔
媅	女 甚
媇	女 亲
媈	女 軍
媉	女 屋
媊	女 前
媋	女 春
媌	女 苗
媍	女 負
媎	女 者
媏	女 耑
媐	巸 女
媑	女 重
媔	女 面
媕	女 弇
媗	女 宣
媘	女 皆
媙	女 威
媜	女 貞
媝	秋 女
媟	女 枼
媠	女 左 月
媡	女 柬
媢	女 冒
媣	女 染
媤	女 思
媥	女 扁
媦	女 胃
媧	女 咼
媨	女 酋
媩	女 胡
媫	女 卜 彐 止
媬	女 保
媮	女 俞
媯	女 為
媰	女 芻
媴	女 袁
媶	女 茸
媷	女 辱
媹	女 留
媺	女 山 一 几 攵
媻	般 女
媼	女 囚 皿
媽	女 馬
媿	女 鬼
嫀	女 秦
嫃	女 真
嫅	女 差
嫆	女 容
嫇	女 冥
嫈	𤇾 女
嫊	女 素
嫋	女 弱
嫍	女 舀
嫎	女 旁
嫏	女 郎
嫐	女 男 女
嫑	不 要
嫓	女 ⺈ LD 比
嫗	女 區
嫙	女 旋
嫛	殹 女
嫝	女 康
嫞	女 庸
嫟	女 匿
嫢	規 女
嫤	女 堇
嫥	女 專
嫧	女 責
嫨	女 廿 口 夫
嫬	女 庶
嫮	女 雩
嫯	敖 女
嫰	女 欶
嫲	女 麻
嫳	敝 女
嫴	女 辜
嫵	女 無
嫶	女 焦
嫷	女 隋
嫸	女 善
嫹	女 黄
嫺	女 閒
嫻	女 閑
嫼	女 黑
嫾	女 粦
嫿	女 畫
嬀	女 爲
嬁	女 登
嬂	女 戠
嬃	須 女
嬄	女 壹
嬅	女 華
嬆	女 翕
嬇	女 貴
嬈	女 堯
嬊	廿 丬 口 匕 女	# 上非“燕”（无灬）
嬋	女 單
嬌	女 喬
嬍	女 山 一 王 攵
嬎	女 免 生
嬏	女 番
嬐	女 僉
嬑	女 意
嬒	女 會
嬓	女 敫
嬔	女 兔 生
嬕	女 睪
嬘	女 遂
嬙	女 嗇
嬚	女 廉
嬜	歆 女
嬝	女 裊
嬞	女 董
嬟	女 義
嬠	女 喿
嬡	女 愛
嬢	女 六 甘 氏
嬣	女 寧
嬤	女 麼
嬦	女 壽
嬧	女 盡
嬨	女 慈
嬩	女 與
嬪	女 賓
嬫	女 榮
嬭	女 爾
嬮	厭 女
嬯	女 臺
嬰	賏 女
嬱	漸 女
嬳	女 蒦
嬵	女 綿
嬶	女 鼻
嬸	女 審
嬹	女 興
嬺	女 慝
嬻	女 賣
嬼	女 劉
嬽	女 四 丨 匚 四 大	# 特殊
嬾	女 頼
孁	霝 女
孂	女 簋
孃	女 襄
孄	女 闌
孆	女 嬰
孇	女 雙
孈	女 巂
孉	女 雚
孊	女 靡
孋	女 麗
孌	龻 女
孍	女 嚴
孎	女 屬
孏	女 蘭
孒	了 一
孞	子 心
孠	司 子
孡	子 台
孧	幼 子
孨	子 子 子
孫	子 系
孭	子 貝
孮	子 宗
孯	臤 子
孲	子 亞
孴	孨 日
孶	茲 子	# 非“孳”
孷	未 攵 厂 子
學	臼 爻 子
孹	辟 子
孻	子 盡
孼	辥 子
孾	子 嬰
孿	龻 子
宂	宀 几
宆	宀 弓
宊	宀 犬
宍	宀 六
宎	宀 夭
宐	宀 夕 一
宑	宀 井
宒	宀 毛
宔	宀 主
宖	宀 弘
実	宀 𡗗
宨	宀 兆
宩	宀 米
宭	宀 君
宮	宀 呂	# 异于“宫”
宯	宀 孝
宱	宀 作
宲	宀 呆
宷	宀 釆
宺	宀 口 一 川
宻	宀 又 丷 山
宼	宀 元 女
寀	宀 采
寃	宀 兔
寈	宀 青
寉	宀 隹
寊	宀 卜 貝
寋	宀 甘 八 ⺋
寍	宀 心 皿
寎	宀 爿 丙
寏	宀 奐
寑	宀 侵
寔	宀 是
寕	宀 丆 四 丁
寖	宀 浸
寗	宓 冉
寘	宀 真
寙	宀 瓜 瓜
寚	宀 王 缶
寛	宀 艹 見	# 非“寬”
寜	宀 心 皿 亅
寠	宀 婁
寢	宀 爿 彐 冖 又
寣	宀 爿 言
實	宀 毌 貝
寧	宀 心 皿 丁
審	宀 番
寪	宀 爲
寫	宀 舄
寬	宀 萈
寭	宀 惠
寯	宀 雋
寱	宀 爿 臬
寲	宀 疑
寳	宀 王 尔 貝
寴	宀 親
寵	宀 龍
寶	宀 王 缶 貝
寷	宀 豐
寽	爪 寸
対	文 寸	# 异于“对”
尀	叵 寸
専	一 由 寸	# 异于“專”
尃	甫 寸
尅	克 寸
將	爿 RS 寸
專	FK 寸
尋	彐 工 口 寸
尌	壴 寸
對	业 羊 寸
導	道 寸
尐	小 丶
尒	人 小
尓	𠂉 小
尗	上 小
尙	小 LD	# 异于“尚”
尛	小 小 小
尞	昚 小
尟	是 少
尠	甚 少
尡	光 昆
尣	八 儿
尦	尣 勺
尩	尣 王
尫	兀 王
尭	十 艹 兀	# 非“堯”
尮	尢 朶
尯	尢 危
尰	尢 重
尲	尢 兼
尳	尢 骨
尵	尢 貴
尶	兀 監
尷	尢 監
屄	尸 穴
屆	尸 士 凵
屇	尸 田
屌	尸 吊
屍	尸 死
屒	尸 辰
屓	尸 貝
屔	丘 尼
屖	尸 辛
屗	尾 寸
屘	尾 子
屚	尸 雨
屛	尸 幷	# 异于“屏”
屜	尸 彳 世
屝	尸 非
屟	尸 枼
屢	尸 婁
層	尸 曾
屧	尸 彳 枼
屨	尸 彳 婁
屩	尸 彳 喬
屪	尸 尞
屫	尸 爿 喬
屬	尸 水 蜀
屭	尸 贔
屰	UA 屮
屲	丿 山
屳	入 山
屴	山 力
屵	山 厂
屶	山 刀
屷	山 乃
屸	山 工
屻	山 刃
屽	山 干
岀	山 山	# 非“出”
岃	山 刃
岄	山 月
岅	山 反
岆	山 夭
岇	山 卬
岉	山 勿
岋	山 及
岎	山 分
岏	山 元
岒	山 今
岓	山 斤
岕	山 介
岝	山 乍
岟	山 央
岡	冂 UA 山
岤	山 穴
岥	山 皮
岦	山 立
岧	山 召
岪	山 弗
岮	山 它
岯	山 丕
岰	山 幼
岲	山 兄
岴	山 丘
岶	山 白
岹	山 召
岺	山 令
岻	山 氐
岼	山 平
岾	山 占
峀	山 田
峅	山 弁
峆	山 合
峇	山 合
峈	山 各
峉	山 各
峊	丿 Y 山
峌	山 至
峍	山 聿
峎	山 艮
峐	山 亥
峑	山 全
峓	山 夷
峔	山 老
峕	山 亠 日	# 非“旹”
峖	山 安
峘	山 亘
峚	山 大 土
峜	山 企
峝	山 同
峞	山 危
峟	山 有
峠	山 卜 二 卜
峢	山 列
峩	山 我
峫	山 邪
峬	山 甫
峮	山 君
峯	山 夆
峲	山 利
峳	山 攸
峴	山 見
峵	山 宏
島	鳥 山
峷	山 辛
峸	山 成
峹	余 山
峺	山 更
峼	山 告
峽	山 夾
峾	沂 山
崅	山 角
崈	宗 山
崉	山 沓
崊	山 林
崋	山 一 艹 BI
崍	山 來
崏	山 昏
崐	山 昆
崑	山 昆
崓	山 固
崕	山 厓
崗	山 LD
崘	山 侖
崙	山 侖
崜	山 垂
崝	山 青
崠	山 東
崢	山 爭
崣	山 委
崥	山 卑
崨	山 疌
崪	山 卒
崫	山 屈
崬	山 東
崯	山 金
崰	山 甾
崱	山 則
崲	山 皇
崳	山 俞
崵	山 昜
崷	山 酋
崸	山 GO
崹	山 帝
崺	山 施
崻	山 待
崼	山 是
嵀	山 柱
嵂	山 律
嵃	山 彦
嵄	山 美
嵆	禾 尤 山
嵈	山 爰
嵉	山 亭
嵍	敄 山
嵏	山 凶 八 夂
嵐	山 風
嵑	山 曷
嵒	品 山
嵓	山 品
嵔	山 畏
嵕	山 凶 八 夂
嵗	山 戌 小
嵙	山 科
嵜	山 竒
嵞	余 屾
嵟	屵 隹
嵠	山 奚
嵡	山 翁
嵢	山 倉
嵣	山 唐
嵤	𤇾 山
嵥	山 桀
嵦	山 豈
嵧	山 留
嵨	山 烏
嵪	山 高
嵭	山 旁
嵮	山 真
嵰	山 兼
嵱	山 容
嵳	山 差
嵵	山 時
嵶	山 弱
嵷	山 從
嵸	山 從
嵹	山 强
嵺	山 翏
嵻	山 康
嵼	山 産
嵽	山 帶
嵾	山 參
嵿	山 頂
嶀	山 雩
嶁	山 婁
嶃	山 斬
嶄	山 斬
嶆	山 曹
嶇	山 區
嶈	山 將
嶉	山 唯
嶊	山 推
嶋	山 鳥
嶌	山 鳥
嶎	山 尉
嶏	屵 配
嶐	山 隆
嶑	山 象
嶔	山 欽
嶕	山 焦
嶖	山 翕
嶗	山 勞
嶘	山 棧
嶚	山 尞
嶛	山 尞
嶜	山 朁
嶞	隋 山
嶠	山 喬
嶡	山 厥
嶢	山 堯
嶣	山 焦
嶤	山 堯
嶥	山 厥
嶧	山 睪
嶨	臼 爻 山
嶩	山 農
嶪	山 業
嶫	山 業
嶬	山 義
嶭	山 丿 Y 辛
嶮	山 僉
嶯	山 戢
嶰	山 解
嶱	山 葛
嶳	山 豕 土 土
嶴	奥 山
嶵	山 罪
嶶	山 微
嶸	山 榮
嶹	山 壽
嶺	山 領
嶻	山 截
嶼	山 與
嶽	山 獄
嶾	山 爪 工 彐 心
嶿	山 需
巀	山 雀 戈
巁	山 厲
巂	山 隹 LD
巃	山 龍
巄	山 龍
巆	山 營
巈	山 鞠
巊	山 嬰
巋	山 歸
巌	山 厳
巎	山 夒
巏	山 雚
巐	山 髜
巑	山 贊
巒	龻 山
巓	山 顚
巔	山 顛
巕	山 薛 女	# 特殊：从女不从子
巖	山 嚴
巗	山 嚴
巘	山 獻
巙	山 夔
巚	山 獻
巟	亡 川
巠	HD 工
巣	VD 果
巤	巛 囗 乂 ZD
巪	巨 X
巬	工 几 夫
巭	功 夫
巰	巠 亠 厶 川
巵	⺁ 一 巴
巶	召 巳
巸	H 巳
巹	丞 己	# 非“卺”
巺	巳 巳 一 八
巻	龹 己	# 异于“卷”
巼	巴 叱
巿	一 巾	# 非“市”
帀	一 巾	# 非“币” 
帄	巾 于
帇	彐 巾	# 彐 交
帉	巾 分
帊	巾 巴
帋	氏 巾
帍	户 巾
帎	巾 冘
帒	代 巾
帓	巾 末
帗	巾 犮
帞	巾 百
帟	亦 巾
帠	臼 巾
帢	巾 合
帣	龹 巾
帤	如 巾
帥	丿 Y 巾
帩	巾 肖
帪	巾 辰
師	丿 Y 帀
帬	君 巾
帯	丗 冖 巾
帰	KD 帚
帲	巾 幷
帳	巾 長
帴	巾 戔
帵	巾 宛
帶	EA 冖 巾
帹	巾 妾
帺	巾 其
帾	巾 者
帿	巾 侯
幀	巾 貞
幁	巾 頁
幃	巾 韋
幆	巾 曷
幇	封 巾
幈	巾 屏
幉	巾 枼
幊	巾 貢
幋	般 巾
幍	巾 舀
幎	巾 冥
幏	巾 家
幐	月 帣
幑	彳 山 一 巾 攵
幒	巾 悤
幓	巾 參
幗	巾 國
幘	巾 責
幙	巾 莫
幚	邦 帛
幜	巾 景
幝	巾 單
幟	巾 戠
幠	巾 無
幣	敝 巾
幤	敞 巾
幥	巾 掌
幦	辟 巾
幧	巾 喿
幨	巾 詹
幩	巾 賁
幫	封 帛
幬	巾 壽
幭	巾 蔑
幮	巾 廚
幯	巾 節
幰	巾 憲
幱	巾 闌
幵	一 𠂇 干	# 非“开”
幷	丿 一 𠂇 丿 干	# 异于“并”
幹	龺 人 干
幾	幺 幺 戈 人	# 下非“戍”
庁	广 丁
庂	广 人
広	广 厶
庅	广 么
庈	广 今
庉	广 屯
庌	广 牙
庍	广 斤
庎	广 介
庒	广 圡
庘	广 甲
庛	广 此
庝	广 冬
庡	广 衣
庢	广 至
庣	广 兆
庨	广 孝
庩	广 余
庪	广 技
庫	广 車
庬	广 尨
庮	广 酉
庯	广 甫
庰	广 并
庲	广 來
庴	广 昔
庺	广 枀
庻	广 廿 从
庽	广 禺
庿	广 苗
廀	广 灾 又
廁	广 則
廂	广 相
廃	广 発
廄	广 艮 殳
廅	广 盍
廇	广 留
廈	广 夏
廌	TX 一 Z 灬
廍	广 部
廎	广 頃
廏	广 皀 殳
廐	广 既
廔	广 婁
廕	广 陰
廗	广 帶
廘	广 鹿
廚	广 尌
廜	广 屠
廝	广 斯
廞	广 欽
廟	广 朝
廠	广 敞
廡	广 無
廢	广 發
廣	TG
廤	庫 叱
廥	广 會
廦	广 辟
廧	广 嗇
廩	广 稟
廫	广 膠
廬	广 盧
廭	广 積
廮	广 嬰
廯	广 鮮
廰	广 聴
廱	广 雝
廲	广 麗
廳	广 聽
廵	廴 巛
廸	廴 由
廹	廴 白
廻	廴 回
廼	廴 西
廽	廴 囗 KD
弅	分 廾
弉	壯 廾
弌	弋 一
弍	弋 二
弎	弋 三
弐	一 弋 二
弒	乂 术 式	# 异于“弑”
弔	弓 丨
弖	弓 一
弙	弓 于
弚	丷 弔
弜	弓 弓
弝	弓 巴
弞	弓 欠
弡	弓 巨
弣	弓 付
弤	弓 氐
弫	弓 臣
弬	弓 H
弮	龹 弓
弰	弓 肖
弲	弓 肙
弳	弓 巠
弴	弓 享
張	弓 長
強	弓 厶 虫
弻	弓 一 囗 人 弓	# 囗 交
弽	弓 枼
弾	弓 単
弿	宀 甘 八 弓
彁	弓 哥
彂	业 弓 矢
彃	弓 畢
彄	弓 區
彅	弓 剪
彆	敝 弓
彇	弓 肅
彈	弓 單
彉	弓 黄
彊	弓 畺
彋	弓 睘
彌	弓 爾
彍	弓 廣
彎	龻 弓
彏	弓 矍
彔	彑 水
彙	彑 冖 果
彚	彐 冖 果
彛	彐 粉 廾
彜	彑 粉 廾
彞	彐 米 糸 廾
彠	尋 蒦
彣	文 彡
彥	文 厂 彡	# 异于“彦” 
彨	丽 彡
彫	周 彡
彮	容 彡
彯	票 彡
彲	麗 彡
彴	彳 勺
彵	彳 也
彶	彳 及
彸	彳 公
彺	彳 王
彽	彳 氐
彾	彳 令
彿	彳 弗
徃	彳 生
徆	彳 西
徍	彳 圭
徎	彳 呈
徏	彳 步
徑	彳 巠
従	彳 UA 止
徔	彳 芝
徖	彳 宗
徚	彳 柬
徝	彳 直
從	彳 从 止
徟	彳 周
徠	彳 來
徢	彳 疌
徣	彳 昔
徤	彳 建
徥	彳 是
徦	彳 叚
徧	彳 扁
復	彳 复
徫	彳 韋
徬	彳 旁
徯	彳 奚
徰	彳 正 正
徱	彳 票
徲	彳 犀
徳	彳 十 四 心	# 异于“德”
徴	彳 山 王 攵	# 异于“徵”
徶	彳 敝
徸	彳 童
徹	彳 育 攵
徺	彳 堯
徻	彳 會
徾	彳 山 言 攵
徿	彳 龍
忀	彳 襄
忁	彳 日 出 大 水
忂	彳 瞿
忇	忄 力
忈	二 心
忊	忄 丁
忋	忄 己
忎	千 心
忓	忄 干
忔	忄 乞
忕	忄 大
忚	忄 也
忛	忄 凡
応	广 心
忟	忄 文
忢	五 心
忣	忄 及
忥	气 心
忦	忄 介
忨	忄 元
忩	公 心
忬	忄 予
忯	忄 氏
忰	忄 卆
忲	忄 太
忴	忄 今
忶	忄 云
忷	忄 凶
忹	忄 王
忼	忄 亢
怇	忄 巨
怈	忄 世
怉	忄 包
怋	忄 民
怌	忄 丕
怐	忄 句
怑	忄 半
怓	忄 奴
怗	忄 占
怘	古 心
怚	忄 且
怞	忄 由
怟	忄 氐
怢	忄 失
怣	失 心
怤	付 心
怬	忄 四
怭	忄 必
怮	忄 幼
怰	忄 玄
怱	匆 心
怲	忄 丙
怳	忄 兄
怴	忄 戉
怶	忄 皮
怷	朮 心	# 异于“怸”
怸	术 心	# 异于“怷”
怹	他 心
怺	忄 永
怽	忄 未
怾	忄 只
恀	忄 多
恄	忄 吉
恅	忄 老
恆	忄 亙	# 异于“恒”
恇	忄 匡
恈	忄 牟
恉	忄 旨
恊	忄 劦
恌	忄 兆
恎	忄 至
恏	好 心
恑	忄 危
恖	囟 心
恗	忄 夸
恘	忄 休
恛	忄 回
恜	忄 式
恞	忄 夷
恟	忄 匈
恠	忄 在
恡	忄 乂 厷
恥	耳 心
恦	忄 向
恮	忄 全
恱	忄 兊
恲	忄 并
恴	亠 日 心
恵	一 由 心
恷	休 心
恾	忄 芒
悀	忄 甬
悁	忄 肙
悂	忄 坒
悅	忄 兌
悇	忄 余
悊	折 心
悋	忄 吝
悎	忄 告
悏	忄 夾
悐	狄 心
悑	忄 甫
悓	忄 見
悕	忄 希
悗	忄 免
悘	医 心
悙	忄 亨
悜	忄 呈
悞	忄 吳
悡	利 心
悤	囱 心
悥	言 心
悧	忄 利
悩	忄 VD 凶
悪	亜 心
悮	忄 吴
悳	十 目 Z 心	# 异于“惪”
悵	忄 長
悶	門 心
悷	忄 戾
悹	官 心
悺	忄 官
悽	忄 妻
悾	忄 空
悿	忄 忝
惀	忄 侖
惁	析 心
惂	忄 臽
惃	忄 昆
惄	叔 心
惈	忄 果
惉	沾 心
惌	宛 心
惍	忄 金
惏	忄 林
惐	忄 或
惒	和 心
惓	忄 卷
惖	易 心
惗	忄 念
惞	忄 欣
惡	亞 心
惢	心 心 心
惣	物 心
惤	忄 弦
惥	臾 心
惪	直 心
惱	忄 巛 囟
惲	忄 軍
惵	忄 枼
惷	春 心
惸	忄 旬 子
惻	忄 則
惼	忄 扁
惽	忄 昬
惾	忄 凶 八 夂
惿	忄 是
愂	勃 心
愄	忄 畏
愅	忄 革
愇	忄 韋
愊	忄 畐
愋	忄 爰
愌	忄 奐
愑	忄 勇
愒	忄 曷
愓	忄 昜
愖	忄 甚
愗	敄 心
愘	忄 客
愙	客 心
愛	爪 冖 心 夂
愜	忄 匧
愝	忄 匽
愞	忄 耎
愡	忄 怱
愢	忄 思
愥	忄 英
愨	士 冖 一 殳 心
愩	忄 貢
愪	忄 員
愬	朔 心
愮	忄 爪 缶
愯	忄 隻
愰	忄 晃
愱	忄 疾
愲	忄 骨
愳	目 目 心
愴	忄 倉
愵	忄 弱
愶	忄 脅
愷	忄 豈
愸	勑 心
愹	忄 容
愺	忄 草
愻	孫 心
愼	忄 眞
愽	忄 尃
愾	忄 氣
慀	忄 奚
慁	圂 心
慂	涌 心
慃	忄 翁
慄	忄 栗
慅	忄 蚤
慇	殷 心
慉	忄 畜
態	能 心
慍	忄 囚 皿
慏	忄 冥
慐	貢 心
慒	忄 曹
慓	忄 票
慔	忄 莫
慖	忄 國
慗	敕 心
慘	忄 參
慙	斬 心
慚	忄 斬
慛	忄 崔
慜	敏 心
慞	忄 章
慟	忄 動
慠	忄 敖
慡	忄 爽
慣	忄 貫
慤	殻 心
慦	救 心
慩	忄 連
慪	忄 區
慫	從 心
慮	虍 思
慯	忄 MA 昜
慱	忄 專
慲	忄 廿 冂 丨 入 入
慳	忄 堅
慴	忄 習
慶	TX 乛 心 夂
慸	帶 心
慹	執 心
慺	忄 婁
慻	忄 眷
慼	戚 心
慽	忄 戚
慾	欲 心
慿	冫 馬 廾 心	# 特殊
憀	忄 翏
憁	忄 悤
憂	一 自 冖 心 夂	# 特殊
憃	舂 心
憄	徝 心
憅	動 心
憆	忄 堂
憇	甜 心
憈	忄 虚
憉	忄 彭
憊	備 心
憌	鈞 心
憍	忄 喬
憏	忄 祭
憐	忄 粦
憑	馮 心
憒	忄 貴
憓	忄 惠
憖	猌 心
憗	來 攵 心
憘	忄 喜
憚	忄 單
憛	忄 覃
憜	忄 隋
憞	忄 敦
憟	忄 粟
憠	厥 心
憡	忄 策
憢	忄 堯
憣	忄 番
憤	忄 賁
憥	勞 心
憦	忄 勞
憪	忄 閒
憫	忄 閔
憮	忄 無
憯	忄 朁
憰	忄 矞
憱	忄 就
憲	宀 丰 四 心
憳	忄 尋
憴	忄 黽
憵	辟 心
憶	忄 意
憸	忄 僉
憹	忄 農
憻	忄 亶
憼	敬 心
憽	忄 葱
憿	忄 敫
懀	忄 會
懁	忄 睘
懃	勤 心
懄	忄 勤
懅	忄 豦
懆	忄 喿
懇	貇 心
應	广 亻 隹 心
懌	忄 睪
懍	忄 稟
懎	忄 嗇
懏	忄 雋
懐	忄 亠 四 衣
懓	忄 愛
懕	厭 心
懖	銛 心
懗	忄 赫
懘	滯 心
懙	忄 與
懚	忄 爪 工 彐 心
懛	忄 臺
懜	忄 夢
懝	忄 疑
懞	忄 蒙
懟	對 心
懠	忄 齊
懡	忄 麽
懢	忄 監
懣	滿 心
懤	忄 壽
懥	忄 疐
懧	忄 寧
懨	忄 厭
懩	忄 養
懪	忄 暴
懫	忄 質
懬	廣 心
懭	忄 廣
懮	忄 憂
懯	敷 心
懰	忄 劉
懱	忄 蔑
懲	徵 心
懳	忄 慧
懴	忄 韯
懶	忄 賴
懷	忄 褱
懸	縣 心
懹	忄 襄
懺	忄 韱
懻	忄 冀
懼	忄 瞿
懽	忄 雚
懾	忄 聶
戀	龻 心
戁	難 心
戂	忄 靡
戃	忄 黨
戄	忄 矍
戅	贑 心
戇	贛 心
戉	戈 Z
戓	戈 口
戔	戈 戈
戙	同 戈
戜	戈 呈
戝	貝 戈
戞	一 自 冖 戈	# 特殊 
戠	音 戈
戦	単 戈
戧	倉 戈
戨	哥 戈
戩	晉 戈
戫	有 或
戯	虚 戈
戰	單 戈
戱	虛 戈
戲	虍 豆 戈
戵	瞿 戈
戶	WM	# 异于“户”但视作户之形近 
戸	一 尸	# 异于“户” 
戹	户 乙
戺	户 巳
戻	户 大
戼	X 一 丨 匚 X	# 特殊 
扄	户 向
扏	扌 九
扐	扌 力
払	扌 厶
扖	扌 入
扗	扌 土
扙	扌 丈
扚	扌 勺
扝	扌 亏
扟	扌 卂
扠	扌 叉
扡	扌 也
扢	扌 乞
扤	扌 兀
扥	扌 丿 七	# 撇 交
扨	扌 刃
扱	扌 及
扲	扌 今
扴	扌 介
扵	扌 人 TD
扷	扌 夭
扸	扌 片
扻	扌 欠
抁	扌 允
抂	扌 王
抅	扌 勾
抆	扌 文
抇	扌 曰
抈	扌 月
抋	扌 心
抌	扌 冘
抍	扌 升
抎	扌 云
抏	扌 元
抐	扌 内
抙	扌 手
抜	扌 友
抝	扌 幻
択	扌 尺
抣	扌 匀
抦	扌 丙
抧	扌 只
抩	扌 冉
抪	扌 布
抭	扌 宀 几
抮	扌 人 彡
抯	扌 且
抰	扌 央
抲	扌 可
抳	扌 尼
抴	扌 世
抶	扌 失
抷	扌 丕
抸	扌 乏
抺	扌 未
抾	扌 去
拀	扌 兄
拁	扌 加
拋	扌 尢 力	# 异于“抛”
拏	奴 手
拑	扌 甘
拕	扌 它
拝	扌 一 丰
拞	扌 丘
拠	扌 処
拡	扌 広
拪	扌 西
拫	扌 艮
拰	扌 任
拲	共 手
拵	扌 存
拸	扌 多
拹	扌 劦
拺	扌 朿
拻	扌 灰
挀	扌 ⺁ 氏
挃	扌 至
挄	扌 光
挅	扌 朶
挆	扌 朵
挊	扌 卜 二 卜
挋	扌 臣
挌	扌 各
挍	扌 交
挏	扌 同
挐	如 手
挒	扌 列
挔	扌 衣
挕	扌 耳
挗	扌 夷
挘	扌 劣
挙	兴 手
挜	扌 亚
挧	扌 羽
挩	扌 兌	# 异于“捝”
挬	扌 孛
挭	扌 更
挮	扌 弟
挰	扌 呈
挱	扌 沙
挳	扌 巠
挴	扌 每
挵	扌 弄
挶	扌 局
挷	扌 邦
挸	扌 見
挻	扌 延
挼	扌 妥
挾	扌 夾
挿	扌 千 日	# 千 交
捀	扌 夆
捁	扌 告
捄	扌 求
捇	扌 赤
捈	扌 余
捊	扌 孚
捑	扌 日 夨
捒	扌 束
捓	扌 邪
捔	扌 角
捖	扌 完
捗	扌 步
捘	扌 夋
捙	扌 車
捚	扌 里
捛	扌 吕
捜	扌 申 又	# 异于“搜”
捝	扌 兑	# 异于“挩”
捠	扌 兵
捤	扌 尾
捥	扌 宛
捦	扌 金
捨	扌 舍
捪	扌 昏
捫	扌 門
捬	扌 府
捰	扌 果
捲	扌 卷
捳	扌 岳
捴	扌 忩
捵	扌 典
捸	扌 隶
捹	扌 奔
捼	扌 委
捾	扌 官
捿	扌 妻
掁	扌 長
掃	扌 彐 冖 巾
掄	扌 侖
掅	扌 青
掆	扌 LD
掋	扌 底
掍	扌 昆
掑	扌 其
掓	扌 叔
掔	臤 手
掕	扌 夌
掗	扌 亞
掙	扌 爭
掚	扌 兩
掛	扌 卦
掜	扌 兒
掝	扌 或
掟	扌 定
採	扌 采
掤	扌 朋
掦	扌 易
掫	扌 取
掯	扌 肯
掱	手 手 手
掲	扌 日 勹 匕	# 异于“揭”
掵	扌 命
掶	扌 庚
掹	扌 孟
掻	扌 又 虫	# 非“搔”
掽	扌 並
掿	扌 若
揀	扌 柬
揁	扌 貞
揂	扌 酋
揃	扌 前
揅	研 手
揇	扌 南
揈	扌 訇
揊	扌 畐
揋	扌 畏
揌	扌 思
揑	扌 臼 工
揓	扌 施
揔	扌 怱
揗	扌 盾
揘	扌 皇
揙	扌 扁
揚	扌 昜
換	扌 奐
揜	扌 弇
揝	扌 昝
揟	扌 胥
揢	扌 客
揤	扌 即
揥	扌 帝
揦	扌 剌
揧	剌 手
揨	扌 亭
揫	秋 手
揬	扌 突
揮	扌 軍
揯	扌 恆
揰	扌 重
揱	削 手
揵	扌 建
揷	扌 千 臼	# 非“插”；千 交
揹	扌 背
揺	扌 爪 干 凵	# 非“摇”
揻	扌 威
揼	扌 泵
揾	扌 昷
搃	扌 总
搄	扌 恒
搆	扌 冓
搇	扌 衾
搈	扌 容
搉	扌 隺
搊	扌 芻
損	扌 員
搎	扌 孫
搑	扌 茸
搕	扌 盍
搖	扌 RS 缶	# 异于“摇”
搗	扌 島
搘	扌 耆
搙	扌 辱
搚	扌 脅
搝	扌 臭
搟	扌 軒
搢	扌 晋
搣	扌 烕
搤	扌 益
搥	扌 追
搧	扌 扇
搨	扌 日 羽
搩	扌 桀
搫	般 手
搮	扌 栗
搯	扌 舀
搰	扌 骨
搱	扌 屖
搲	扌 窊
搳	扌 害
搵	扌 囚 皿
搶	扌 倉
搷	扌 真
搸	扌 秦
搹	扌 鬲
搻	合 手 手
搼	扌 拳
搾	扌 窄
摀	扌 RZA
摂	扌 耳 V
摃	扌 貢
摉	扌 穴 人 夕
摋	扌 殺
摌	扌 産
摍	扌 宿
摎	扌 翏
摐	扌 從
摑	扌 國
摓	扌 逢
摕	扌 帶
摖	扌 祭
摗	扌 欶
摙	扌 連
摚	扌 堂
摜	扌 貫
摝	扌 鹿
摟	扌 婁
摠	扌 悤
摡	扌 既
摢	扌 虖
摣	扌 虘
摤	扌 爽
摥	扌 𠂉 昜
摦	扌 瓠
摨	扌 犀
摪	扌 將
摫	扌 規
摬	扌 竟
摮	敖 手
摯	執 手
摰	埶 手
摱	扌 曼
摲	扌 斬
摳	扌 區
摵	扌 戚
摶	扌 專
摷	扌 巢
摻	扌 參
摼	扌 堅
摾	扌 强
摿	扌 人 音
撀	殸 手
撁	扌 牽
撃	軗 手
撆	敝 手
撈	扌 勞
撉	敦 手
撊	扌 閒
撋	扌 閏
撌	扌 貴
撍	扌 朁
撎	扌 壹
撏	扌 尋
撐	扌 牚
撓	扌 堯
撔	扌 景
撗	扌 黄
撘	扌 答
撚	扌 然
撛	扌 粦
撜	扌 登
撝	扌 爲
撟	扌 喬
撠	扌 戟
撡	扌 叅
撢	扌 覃
撣	扌 單
撥	扌 發
撦	扌 奢
撧	扌 絕
撨	扌 焦
撪	扌 軬
撫	扌 無
撯	扌 着
撱	扌 隋
撲	扌 菐
撳	扌 欽
撴	扌 敦
撶	扌 華
撹	扌 覚
撻	扌 達
撽	扌 敫
撾	扌 過
撿	扌 僉
擁	扌 雍
擃	扌 農
擄	扌 虜
擆	扌 著
擇	扌 睪
擈	扌 業
擉	扌 蜀
擊	車 凵 殳 手
擋	扌 當
擌	扌 筴
擏	扌 敬
擑	扌 戢
擓	扌 匯
擔	扌 詹
擕	扌 雋
擖	扌 葛
擙	扌 奥	# 从奥不从奧
據	扌 豦
擛	扌 葉
擜	扌 献
擝	扌 盟
擟	扌 爾
擠	扌 齊
擡	扌 臺
擣	扌 壽
擥	臣 M 四 手
擧	與 手
擨	扌 歋
擩	扌 需
擪	厭 手
擫	扌 厭
擬	扌 疑
擭	扌 蒦
擮	扌 截
擯	扌 賓
擰	扌 寧
擱	扌 閣
擲	扌 鄭
擳	扌 節
擴	扌 廣
擵	扌 摩
擶	扌 箭
擷	扌 頡
擸	扌 巤
擹	扌 歎
擺	扌 罷
擻	扌 數
擼	扌 魯
擽	扌 樂
擾	扌 憂
攁	扌 養
攂	扌 畾
攃	扌 蔡
攄	扌 慮
攅	扌 賛
攆	扌 輦
攇	扌 憲
攈	扌 麇
攊	扌 歷
攋	扌 賴
攌	扌 圜
攍	扌 嬴
攎	扌 盧
攏	扌 龍
攐	扌 褰
攑	扌 舉
攓	扌 蹇
攔	扌 闌
攕	扌 韱
攖	扌 嬰
攗	扌 麋
攙	扌 毚
攚	扌 營
攛	扌 竄
攜	扌 巂
攝	扌 聶
攞	扌 羅
攟	扌 麕
攠	扌 靡
攡	扌 離
攢	扌 贊
攣	龻 手
攤	扌 難
攦	扌 麗
攧	扌 顛
攨	扌 窊 瓜 瓜
攩	扌 黨
攪	扌 覺
攬	扌 覽
攭	扌 蠡
攰	支 力
攱	立 支
攲	奇 支
攳	支 尋
攷	丂 攵
攺	巳 攵
攼	干 攵
敀	白 攵
敁	占 攴
敂	句 攵
敃	民 攵
敄	矛 攵
敆	合 攴
敇	朿 攵
敊	尗 攴
敋	各 攵
敍	余 攴
敎	乂 𠂇 子 攵	# 异于“教”
敐	辰 攵
敒	伸 攵
敓	兌 攵
敗	貝 攵
敘	余 攵
敚	兑 攵
敜	念 攵
敟	典 攵
敠	叕 攴
敡	易 攴
敤	果 攴
敥	炎 攴
敧	奇 攴
敨	咅 攵
敪	叕 攵
敭	昜 攵
敮	臿 攴
敯	昬 攴
敱	豈 攴
敳	豈 攵
敵	啇 攵
敶	陳 攵
數	婁 攵
敹	卜 冖 釆 攵
敺	區 攴
敻	⺈ LD 目 攵	# 异于“夐”
敼	喜 攴
敽	喬 攴
敾	善 攵
敿	喬 攵
斀	蜀 攴
斁	睪 攵
斂	僉 攵
斃	敝 死
斄	未 攵 厂 來
斅	學 攴
斆	學 攵
斈	文 子
斉	文 ND
斊	文 耳
斍	文 見
斎	文 ND 示
斏	文 良
斒	文 扁
斔	蚉 臾
斕	文 闌
斖	文 舋
斘	夕 斗
斚	厶 厶 冖 斗
斞	臾 斗
斢	黄 斗
斦	斤 斤
斨	爿 斤
斪	句 斤
斬	車 斤
斮	昔 斤
斱	者 斤
斲	BZ 斤
斳	堇 斤
斴	粦 斤
斵	RH 丶 刀 亞 斤
斷	Z 幺 幺 一 幺 幺 斤
斸	屬 斤
斺	方 介
斻	方 𠂉 几
斾	方 𠂉 巾
斿	方 𠂉 子
旀	方 厼
旂	方 𠂉 斤
旇	方 𠂉 皮
旈	方 亠 厶 川
旉	甫 方
旊	方 𠂉 瓦
旍	方 𠂉 令
旑	方 奇
旓	方 𠂉 肖
旔	方 对
旕	於 叱
旘	方 戠
旙	方 番
旚	方 𠂉 票
旛	方 𠂉 番
旜	方 𠂉 亶
旝	方 𠂉 會
旟	方 𠂉 與
旡	匚 儿	# 匚 交
旣	皀 旡
旤	咼 旡
旪	日 十
旫	日 刀
旲	日 大
旳	日 勺
旹	屮 一 日
旼	日 文
旽	日 屯
旾	屯 日
昁	日 巿
昅	日 及
昋	天 日
昍	日 日
昐	日 分
昑	日 今
昖	日 公
昗	日 六
昘	日 方
昚	大 丷 日
昛	日 巨
昜	日 一 勿
昞	日 丙
昢	日 出
昦	日 夰
昩	日 末
昬	民 日
昮	日 功
昰	日 正
昲	日 弗
昷	日 皿
昸	日 冬
昹	日 永
昻	日 卭
昿	日 広
晀	日 兆
時	日 寺
晄	日 光
晆	日 圭
晇	日 夸
晈	日 交
晉	二 厶 厶 日	# 异于“晋”
晍	日 同
晎	日 共
晑	日 向
晘	日 旱
晛	日 見
晜	日 弟
晝	⺻ 日 一
晠	日 成
晣	日 折
晥	日 完
晧	日 告
晩	日 ⺈ K 儿	# 异于“晚”
晬	日 卒
晭	日 周
晲	日 兒
晳	析 日
晵	户 攵 日
晸	日 政
晹	日 易
晻	日 奄
晼	日 宛
晽	日 林
晿	日 昌
暀	日 往
暁	日 尭
暃	日 非
暆	日 施
暈	日 軍
暉	日 軍
暊	日 頁
暋	敃 日
暍	日 曷
暎	日 英
暏	日 者
暐	日 韋
暒	日 星
暓	敄 日
暔	日 南
暘	日 昜
暙	日 春
暚	日 爪 缶
暛	日 差
暜	竝 日
暞	日 臬
暟	日 豈
暠	日 高
暡	日 翁
暢	申 昜
暣	日 氣
暤	日 皋
暥	日 晏
暦	厂 林 日
暩	日 祭
暪	日 廿 冂 丨 入 入
暫	斬 日
暬	埶 日
暭	日 皐
暯	日 莫
暰	日 從
暱	日 匿
暳	日 彗
暷	日 專
暸	日 尞
暺	日 單
暻	日 景
暼	敝 日
暽	日 粦
曀	日 壹
曁	旣 旦
曂	日 黄
曃	日 逮
曄	日 華
曅	日 華
曆	厤 日
曇	日 雲
曉	日 堯
曊	日 費
曋	日 覃
曍	日 臯
曎	日 睪
曏	日 鄉
曐	晶 生
曑	晶 人 彡
曒	日 敫
曓	日 出 大 本	# 下从本不从夲
曔	日 敬
曕	日 詹
曖	日 愛
曗	日 業
曘	日 需
曚	日 蒙
曞	日 厲
曟	晶 辰
曠	日 廣
曡	晶 冝
曢	日 寮
曣	日 燕
曤	日 霍
曥	日 盧
曧	日 融
曨	日 龍
曪	日 羅
曫	龻 日
曬	日 麗
曭	日 黨
曮	日 嚴
曯	日 屬
曱	日 丨	# 日 交
曵	曳 丶
曶	勿 日
書	XB 日
曺	一 由 日
曻	日 舛
曽	丷 田 日
朁	旡 旡 日
朂	日 耳 力
會	亼 四 日
朄	申 柬
朅	去 曷
朆	曾 勿
朇	會 卑
朌	月 分
朎	月 令
朑	月 世
朒	月 肉
朖	月 良
朘	月 夋
朙	囧 月
朚	亡 明
朜	月 享
朞	其 月
朠	月 英
朡	月 凶 八 夂
朢	臣 月 王
朣	月 童
朤	朋 朋
朥	月 勞
朧	月 龍
朩	F	# 木之形近
朮	F 丶	# 术之形近
朰	木 乙
朲	木 人
朶	乃 木
朷	木 刀
朹	木 九
朻	木 丩
朼	木 匕
朾	木 丁
朿	木 冂
杁	木 入
杅	木 于
杇	木 亏
杊	木 川
杋	木 凡
杍	木 子
杒	木 刃
杔	木 乇
杗	亡 木
杘	尸 木
杚	木 乞
杛	木 弓
杝	木 也
杢	木 工
杣	木 山
杤	木 万
杦	木 久
杫	木 止
杬	木 元
杮	木 巿	# 非“柿”
東	木 日
杴	木 欠
杶	木 屯
杸	木 殳
杹	木 化
杺	木 心
杽	木 手
枀	公 木
枂	木 月
枃	木 匀
枆	木 毛
枈	比 木
枊	木 卬
枌	木 分
枎	木 夫
枏	木 冄
枑	木 互
枒	木 牙
枓	木 斗
枔	木 今
枖	木 夭
枙	木 厄
枛	木 爪
枟	木 云
枠	木 卆
枡	木 升
枤	木 犬
枦	木 户
枩	木 公
枬	木 丹
枮	木 占
枱	木 台
枴	木 叧
枺	木 末
枻	木 世
枼	世 木
枽	卋 木
枾	木 十 ND	#*** 特殊；十 交
枿	木 卉
柀	木 皮
柂	木 𠂉 也
柅	木 尼
柆	木 立
柇	木 禾
柉	木 乏
柋	代 木
柌	木 司
柍	木 央
柎	木 付
柕	木 矛
柗	木 八 口
柛	木 申
柟	木 冉
柡	木 二 水
柣	木 失
柤	木 且
柦	木 旦
柧	木 瓜
柨	木 布
柪	木 幼
柫	木 弗
柭	木 犮
柮	木 出
柲	木 必
柵	木 冊	# 异于“栅”
柶	木 四
柸	木 丕
柹	木 丿 Z 丨 丿
柺	木 另
査	木 且
柼	木 穴
柾	木 正
栁	木 夘
栂	木 母
栃	木 ⺁ 万
栄	VD 冖 木
栆	一 口 丨 人 TD	# 特殊：口 交
栍	木 生
栔	丰 刀 木
栕	木 臣
栘	木 多
栙	木 夅
栚	木 关
栛	木 劦
栜	木 朿
栞	幵 木
栠	任 木
栢	木 百
栣	木 任
栤	木 冰
栥	次 木
栦	木 州
栧	木 曳
栨	木 次
栫	木 存
栬	木 色
栭	木 而
栮	木 耳
栯	木 有
栰	木 伐
栱	木 共
栵	木 列
栶	木 因
栺	木 旨
栿	木 伏
桇	如 木
桋	木 夷
桍	木 夸
桏	木 邛
桒	十 艹 木
桖	木 血
桗	木 朶
桘	木 丿 Y
桙	木 牟
桚	木 巛 夕
桛	木 卜 二 卜
桜	木 VD 女
桝	木 舛
桞	木 邜
桟	木 HM
桪	木 寻
桬	沙 木
桭	木 辰
桮	木 否
桰	木 氏 口
桱	木 巠
桳	木 厶 夲
桵	木 妥
桸	木 希
桺	木 丣
桻	木 夆
桼	木 人 水
桽	木 坐
桾	木 君
桿	木 旱
梀	木 束
梂	木 求
梄	木 酉
梇	木 弄
梈	木 亨
梉	木 壯
梊	折 木
梋	木 肙
梍	木 皂
梎	木 皀
梐	木 坒
梑	木 狄
梒	木 含
梔	木 巵
梕	木 忍
梖	木 貝
梘	木 見
梙	木 串
梚	木 免
梛	木 那
梜	木 夾
條	亻 丨 条
梞	木 忌
梟	鳥 木
梡	木 完
梤	木 山 分
梥	穴 厶 木
梩	木 里
梪	木 豆
梫	木 彐 冖 又
梬	木 甹
梮	木 局
梱	木 困
梲	木 兌
梶	木 尾
梷	占 又 木
梸	木 利
梹	木 兵
梺	林 下
梻	木 佛
棃	禾 勹 丿 木
棄	亠 厶 廿 木	# 廿 交
棅	木 秉
棆	木 侖
棇	木 忩
棈	木 青
棊	其 木
棌	木 采
棎	木 罙
棏	木 日 一 寸
棑	木 非
棔	木 昏
棖	木 長
棗	朿 朿
棙	木 戾
棛	木 育
棜	木 於
棝	木 固
棞	木 囷
棟	木 東
棡	木 LD
棢	木 LD
棥	木 爻 木
棦	木 争
棧	木 戔
棩	木 ND
棭	木 夜
棯	木 念
棲	木 妻
棳	木 叕
棴	木 服
棶	木 來
棷	木 取
棸	取 木
棾	林 冗
棿	木 兒
椂	木 录
椃	木 虎
椄	木 妾
椇	木 具
椈	木 匊
椉	亠 舛 木
椊	木 卒
椌	木 空
椏	木 亞
椔	木 甾
椕	木 分 木
椖	木 房
椗	木 定
椘	林 之
椙	木 昌
椚	木 門
椛	木 花
検	木 亼 口 人	# 口 交
椝	规 木
椞	析 木
椡	木 到
椢	木 国
椣	木 典
椥	木 知
椦	木 劵
椧	木 命
椨	木 府
椩	木 庚
椫	木 单
椬	木 宜
椮	木 参
椯	木 耑
椱	木 复
椲	木 韋
椳	木 畏
椵	木 叚
椶	木 凶 八 夂
椷	木 咸
椺	木 保
椻	木 匽
椼	木 衍
椾	木 前
楀	木 禹
楁	木 客
楃	木 屋
楄	木 扁
楅	木 畐
楆	木 要
楇	木 咼
楈	木 胥
楉	木 若
楊	木 昜
楋	木 剌
楌	木 彦
楍	木 口 口 口
楎	木 軍
楏	木 奎
楐	木 界
楑	木 癸
楓	木 風
楕	木 左 月
楖	木 即
楘	敄 木
楛	木 苦
楜	木 胡
楟	木 亭
楡	木 兪	# 非“榆”
楢	木 酋
楤	木 怱
楥	木 爰
楧	木 英
楨	木 貞
楬	木 曷
業	KU
楰	木 臾
楲	木 威
楳	木 某
楴	木 帝
極	木 亟
楶	次 呆
楺	木 柔
楻	木 皇
楽	V 白 木
楾	木 泉
楿	木 香
榁	木 室
榊	木 神
榋	木 彐 彐 彐
榌	木 飛
榎	木 夏
榏	木 益
榐	木 展
榒	木 弱
榓	木 必 皿
榗	木 晋
榙	木 荅
榚	木 羔
榝	木 殺
榞	木 原
榟	木 宰
榠	木 冥
榡	木 素
榢	木 家
榣	木 爪 缶
榤	木 桀
榥	木 晃
榦	龺 人 木
榩	木 虔
榪	木 馬
榬	木 袁
榮	𤇾 木
榯	木 時
榲	木 囚 皿
榳	木 庭
榵	木 茸
榶	木 唐
榸	木 埋
榹	木 虒
榺	月 桊
榼	木 盍
榽	木 奚
榾	木 骨
榿	木 豈
槀	高 木
槂	木 孫
槄	木 舀
槅	木 鬲
槆	木 荀
槇	木 眞
槈	木 辱
槉	木 疾
構	木 冓
槍	木 倉
槏	木 兼
槑	呆 呆
槒	木 畜
槓	木 貢
槕	木 桌
槖	士 冖 石 木
槗	木 右 LD
様	木 羊 水
槙	木 真
槝	木 島
槞	木 竜
槡	木 桑
槢	木 習
槣	木 寄
槤	木 連
槥	木 彗
槦	木 庸
槧	斬 木
槨	木 郭
槩	既 木
槪	木 旣
槫	木 專
槬	木 瓠
槮	木 參
槯	木 崔
槰	木 逢
槳	將 木
槴	木 扈
槵	木 患
槶	木 國
槷	埶 木
槸	木 埶
槹	木 皐
槺	木 康
槻	木 規
槼	規 木
槾	木 曼
樀	木 啇
樁	木 舂
樂	幺 白 幺 木
樃	木 朗
樄	木 陳
樅	木 從
樆	木 离
樇	木 脩
樈	木 竟
樉	木 爽
樋	木 通
樌	木 貫
樍	木 責
樎	木 宿
樏	木 累
樐	木 鹵
樑	木 梁
樒	木 密
樓	木 婁
樔	木 巢
樕	木 欶
樖	合 柯
標	木 票
樚	木 鹿
樛	木 翏
樜	木 庶
樝	木 虘
樞	木 區
樠	木 廿 冂 丨 入 入
樢	木 鳥
樣	木 羕
樤	木 條
樥	木 莑
樦	木 ⺮ 主
樧	木 乂 术 殳	# 异于“榝”
権	木 𠂉 一 隹
樫	木 堅
樬	木 悤
樭	木 基
樮	木 西 火
樰	木 雪
樲	木 貳
樳	木 尋
樴	木 戠
樶	木 最
樷	林 取
樸	木 菐
樹	木 尌
樺	木 華
樻	木 貴
樼	木 孱
樿	木 單
橀	木 亠 厶 川 皿
橁	木 筍
橂	木 奠
橃	木 發
橅	木 無
橆	𠂉 EA 林
橈	木 堯
橉	木 粦
橊	木 畱
橋	木 喬
橌	木 閒
橍	木 閏
橎	木 番
橏	木 善
橒	木 雲
橓	木 舜
橔	木 敦
橕	木 牚
橖	木 棠
橗	木 萌
橚	木 肅
橜	厥 木
橝	木 覃
機	木 幾
橠	木 袲
橢	木 隋
橣	木 宀 心 LD
橤	惢 木
橧	木 曾
橨	木 賁
橩	木 焭	# 字形存疑
橪	木 然
橫	木 黃
橬	木 朁
橭	木 辜
橮	木 貿
橯	木 勞
橰	木 臯
橲	木 喜
橳	木 勝
橴	木 紫
橵	木 散
橶	木 戟
橷	木 兠
橸	木 晶
橺	木 間
橻	木 丑 丑 丑
橽	木 達
橾	木 喿
橿	木 畺
檁	木 稟
檂	木 農
檃	阝 爪 工 彐 木
檅	木 歲
檆	木 煔
檇	木 雋
檈	木 睘
檉	木 聖
檊	木 幹
檋	木 輂
檌	木 罪
檍	木 意
檏	木 業
檒	林 風
檓	木 毁
檔	木 當
檕	車 凵 殳 木
檖	木 遂
檘	木 辟
檙	木 鼎
檚	木 楚
檛	木 過
檜	木 會
檝	木 戢
檟	木 賈
檡	木 睪
檢	木 僉
檣	木 嗇
檤	木 道
檥	木 義
檦	木 剽
檧	木 葱
檨	木 羡
檪	木 楽
檭	木 銀
檮	木 壽
檯	木 臺
檰	木 綿
檱	木 箕
檲	木 團
檳	木 賓
檴	木 蒦
檵	木 Z 幺 幺 一 幺 幺
檶	木 奩
檷	木 爾
檸	木 寧
檹	木 旖
檺	木 豪
檻	木 監
檼	木 爪 工 彐 心
檽	木 需
檾	𤇾 林
檿	厭 木
櫀	木 綦
櫁	木 蜜
櫂	木 翟
櫃	木 匱
櫄	木 熏
櫅	木 齊
櫇	木 頗
櫈	木 凳
櫉	木 厂 尌
櫊	木 閣
櫋	木 臱
櫌	木 憂
櫍	木 質
櫎	木 廣
櫏	木 遷
櫐	畾 木
櫑	木 畾
櫒	木 蔡
櫓	木 魯
櫔	木 厲
櫕	木 賛
櫖	木 慮
櫗	木 蔑
櫘	木 慧
櫙	木 蓲
櫚	木 閭
櫛	木 節
櫜	一 中 冖 咎 木
櫝	木 賣
櫞	木 緣
櫟	木 樂
櫠	木 廢
櫡	木 箸
櫢	木 數
櫣	木 辶 莗	# 特殊：右非“蓮”
櫤	木 箭
櫥	木 廚
櫦	木 慶
櫧	木 諸
櫨	木 盧
櫩	木 閻
櫪	木 歷
櫫	豬 木
櫬	木 親
櫭	木 暨
櫮	木 噩
櫯	木 穌
櫰	木 褱
櫱	辥 木
櫲	木 豫
櫳	木 龍
櫴	木 賴
櫵	木 蕉
櫶	木 憲
櫷	木 龜
櫸	木 舉
櫹	木 蕭
櫺	木 霝
櫻	木 嬰
櫼	木 韱
櫽	隱 木
櫾	木 繇
櫿	木 營
欀	木 襄
欁	木 農 木
欃	木 毚
欄	木 闌
欅	木 擧
欆	木 雙
欇	木 聶
欈	木 巂
欉	木 叢
權	木 雚
欋	木 瞿
欌	木 藏
欍	木 舊
欎	棥 冖 艮 寸
欏	木 羅
欐	木 麗
欑	木 贊
欒	龻 木
欓	木 黨
欔	木 矍
欕	木 嚴
欖	木 覽
欗	木 蘭
欘	木 屬
欙	木 纍
欚	木 蠡
欛	木 霸
欜	木 囊
欝	棥 四 艮 寸
欞	木 靈
欟	木 觀
欥	日 欠
欦	今 欠
欨	句 欠
欩	召 欠
欪	出 欠
欫	𠂉 一 止 欠
欬	亥 欠
欭	因 欠
欮	屰 欠
欯	吉 欠
欰	血 欠
欱	合 欠
欳	卜 LD 欠
欴	丶 艮 欠
欵	匕 矢 欠
欶	束 欠
欼	叕 欠
欽	金 欠
欿	臽 欠
歀	柰 欠
歁	甚 欠
歂	耑 欠
歄	咼 欠
歈	俞 欠
歊	高 欠
歋	虒 欠
歍	烏 欠
歎	廿 口 夫 欠
歏	堇 欠
歐	區 欠
歑	虖 欠
歒	啇 欠
歓	𠂉 一 隹 欠
歔	虚 欠
歕	賁 欠
歖	喜 欠
歗	肅 欠
歘	焱 欠
歚	善 欠
歛	僉 欠
歜	蜀 欠
歝	睪 欠
歞	㬎 欠
歟	與 欠
歠	叕 酉 欠
歡	雚 欠
歨	止 止
歩	止 少
歫	止 巨
歬	止 舟
歭	止 寺
歮	止 止 止
歯	止 米 凵
歰	刃 刃 止 止	# 算上下结构
歱	止 重
歲	止 戌 小
歳	止 戌 小
歴	厂 林 止
歵	止 責
歶	此 禺
歷	厤 止
歸	丿 Y 止 帚
歺	卜 夕
歽	歹 斤
歾	歹 勿
歿	歹 力 又	# 异于“殁”
殀	歹 夭
殅	歹 生
殈	歹 血
殌	歹 巠
殎	歹 夾
殏	歹 求
殐	歹 束
殑	歹 克
殔	歹 隶
殕	歹 咅
殗	歹 奄
殘	歹 戔
殙	歹 昏
殜	歹 枼
殝	歹 秦
殞	歹 員
殟	歹 昷
殠	歹 臭
殢	歹 帶
殤	歹 𠂉 昜
殥	歹 寅
殦	歹 鳥
殧	歹 就
殨	歹 貴
殩	歹 歹 又 米	# 特殊：从歹不从歺
殫	歹 單
殬	歹 睪
殭	歹 畺
殮	歹 僉
殯	歹 賓
殰	歹 賣
殱	歹 韯
殲	歹 韱
殶	主 殳
殸	声 殳
殹	医 殳
殺	杀 殳
殻	壳 殳
殼	士 冖 一 几 殳
殽	肴 殳
殾	者 殳
毀	臼 土 殳	# 非“毁”
毃	高 殳
毄	軎 殳
毆	區 殳
毇	臼 米 殳
毈	卵 段
毉	殹 巫
毊	殸 喬
毎	𠂉 毌	# 异于“每”
毑	母 也
毘	田 比
毚	⺈ 口 比 兔
毜	毛 小
毝	毛 彡
毞	比 毛
毟	少 毛
毠	加 毛
毢	毛 西
毣	羽 毛
毤	兊 毛
毥	毛 旬
毦	耳 毛
毧	毛 戎
毨	毛 先
毩	毛 米
毬	毛 求
毭	豆 毛
毮	扌 毟
毰	毛 咅
毱	毛 匊
毲	叕 毛
毴	毛 非
毶	毛 参
毷	冒 毛
毸	毛 思
毺	毛 俞
毻	左 月 毛
毼	曷 毛
毾	日 羽 毛
毿	參 毛
氀	婁 毛
氁	毛 莫
氂	未 攵 厂 毛
氃	童 毛
氄	矞 毛
氈	亶 毛
氉	喿 毛
氊	毛 亶
氋	蒙 毛
氌	毛 魯
氎	疉 毛
氒	氏 十
気	气 乂
氜	气 日
氝	气 内
氞	气 丙
氠	气 申
氣	MY
氥	气 西
氫	气 巠
氬	气 亞
氭	气 東
氱	气 昜
氳	气 囚 皿	# 异于“氲”
氶	乛 水
氷	丶 水
氹	乙 水
氺	KV	AAA
氻	氵 力
氼	水 人
汃	氵 八
汄	氵 人
汅	氵 丂
汌	氵 川
汍	氵 丸
汎	氵 凡
汏	氵 大
汑	氵 乇
汒	氵 亡
汓	氵 子
汖	山 水
汘	氵 千
汙	氵 于
汚	氵 亐
汢	氵 土
汣	氵 久
汥	氵 支
汦	氵 氏
汬	井 水
汮	氵 匀
汯	氵 厷
汱	氵 犬
汳	氵 反
汵	氵 今
汷	氵 夂
汸	氵 方
決	氵 夬
汻	氵 午
汼	氵 牛
汿	氵 予
沀	水 予
沊	冘 水
沋	氵 尤
沍	氵 互
沎	氵 化
沑	氵 丑
沒	氵 YM 又	# 异于“没”
沕	氵 勿
沖	氵 中
沗	天 水
沜	氵 片
沝	水 水
沞	氵 帀
沠	氵 爪
沢	氵 尺
沬	氵 未
沯	水 石
沰	氵 石
沴	氵 人 彡
沵	氵 尔
沶	氵 示
沷	氵 犮
泀	氵 司
況	氵 兄
泆	氵 失
泈	氵 冬
泋	氵 卉
泍	氵 本
泎	氵 乍
泏	氵 出
泑	氵 幼
泒	氵 瓜
泘	氵 乎
泝	氵 斥
泟	氵 正
泤	氵 以
泦	氵 尻
泧	氵 戉
泩	氵 生
泬	氵 穴
泭	氵 付
泲	氵 丿 Z 丨 M
泴	水 皿
泹	氵 旦
泿	氵 艮
洀	氵 舟
洂	氵 亦
洃	氵 灰
洅	氵 再
洆	氵 丞
洉	氵 后
洊	氵 存
洍	氵 H
洏	氵 而
洐	氵 行
洔	氵 寺
洕	氵 八 月
洖	氵 吴
洜	各 水
洝	氵 安
洟	氵 夷
洠	氵 牟
洡	氵 耒
洤	氵 全
洦	氵 百
洩	氵 曳
洬	氵 夙
洯	丰 刀 水
洰	氵 巨
洶	氵 匈
洷	氵 至
浀	氵 曲
浂	氵 关
浄	氵 争
浌	氵 伐
浖	氵 寽
浗	氵 求
浘	氵 尾
浝	氵 尨
浢	氵 豆
浤	氵 宏
浧	氵 呈
浨	氵 宋
浫	氵 罕
浱	氵 辰
浳	氵 弋 月
浵	氵 彤
浶	氵 牢
浹	氵 夾
浺	氵 忡
浻	氵 LD
浽	氵 妥
浾	氵 赤
浿	氵 貝
涀	氵 見
涁	氵 杉
涃	氵 困
涆	氵 旰
涇	氵 巠
涊	氵 忍
涋	氵 宊
涏	氵 廷
涒	氵 君
涖	氵 位
涗	氵 兌
涙	氵 戻
涚	氵 兑
涜	氵 売
涥	氵 亨
涬	氵 幸
涭	氵 受
涰	氵 叕
涱	氵 長
涳	氵 空
涶	氵 垂
涷	氵 東
涹	氵 委
涺	氵 居
涻	氵 舍
涼	氵 京
涽	氵 昏
涾	氵 沓
淁	氵 妾
淂	氵 日 一 寸
淃	氵 卷
淈	氵 屈
淉	氵 果
淊	氵 臽
淍	氵 周
淎	氵 奉
淐	氵 昌
淒	氵 妻
淓	氵 芳
淔	氵 直
淕	氵 坴
淗	氵 匊
淚	氵 戾
淛	氵 制
淢	氵 或
淣	氵 兒
淥	氵 彔
淧	氵 宓
淨	氵 爭
淩	氵 夌
淪	氵 侖
淭	氵 户 木
淰	氵 念
淲	氵 虎
淵	氵 ND
淶	氵 來
淸	氵 靑
淺	氵 戔
淽	氵 芷
淾	金 水
淿	氵 帛
渀	氵 奔
渁	氵 水 水
渂	氵 旻
渃	氵 若
渄	氵 非
渆	氵 并 刂
渇	氵 日 勹 匕
済	氵 斉
渉	氵 歩
渋	氵 止 V
渏	氵 奇
渒	氵 卑
渓	氵 爪 夫
渕	氵 关 刂
渘	氵 柔
渙	氵 奐
減	氵 咸
渜	氵 耎
渞	氵 首
渢	氵 風
渦	氵 咼
渧	氵 帝
渨	氵 畏
渪	氵 禹
測	氵 則
渮	氵 苛
渱	氵 虹
渳	氵 弭
渵	氵 苗
渶	氵 英
渷	氵 兗
渹	氵 訇
渻	氵 省
渽	氵 哉
渾	氵 軍
渿	氵 柰
湀	氵 癸
湁	氵 拾
湂	氵 咢
湅	氵 柬
湆	氵 音
湇	氵 立 月
湈	氵 某
湊	氵 奏
湋	氵 韋
湌	氵 食
湏	氵 頁
湐	氵 柏
湒	氵 咠
湕	氵 建
湗	氵 封
湙	氵 奕
湚	氵 胤
湞	氵 貞
湠	氵 炭
湡	氵 禺
湢	氵 畐
湤	氵 施
湥	氵 突
湦	氵 星
湧	氵 勇
湨	氵 狊
湩	氵 重
湪	氵 彖
湬	秋 水
湭	氵 酋
湯	氵 昜
湰	氵 夂 一 生
湱	氵 砉
湳	氵 南
湵	氵 羊 久
湶	氵 泉
湷	氵 春
湸	氵 亮
湹	氵 厘
湺	氵 保
湻	氵 亯
湼	氵 臼 工
湽	氵 巛 一 田
満	氵 艹 両
溂	氵 剌
溄	氵 山 夂 BI
溈	氵 為
溊	氵 叚
溋	氵 盈
溌	氵 発
溎	氵 桂
溑	氵 小 貝
溒	氵 袁
溓	氵 兼
溔	氵 羔
溕	氵 冡
準	淮 十
溗	氵 乘
溙	氵 泰
溛	氵 窊
溝	氵 冓
溡	氵 時
溣	氵 倫
溤	氵 馬
溨	氵 栽
溩	氵 烏
溫	氵 囚 皿	# 非“温”
溬	氵 羗
溭	氵 畟
溮	氵 師
溰	氵 豈
溳	氵 員
溸	氵 素
溼	氵 一 幺 幺 土
溾	氵 鬼
溿	氵 畔
滀	氵 畜
滄	氵 倉
滅	氵 烕
滈	氵 高
滊	氵 氣
滌	氵 條
滎	𤇾 水
滐	氵 桀
滒	氵 哥
滖	氵 衰
滙	氵 匚 隹
滛	氵 爪 缶
滜	氵 皋
滝	氵 竜
滣	氵 唇
滬	氵 扈
滭	氵 畢
滮	氵 彪
滯	氵 帶
滰	氵 竟
滱	氵 寇
滲	氵 參
滳	氵 商
滵	氵 密
滶	氵 敖
滷	氵 鹵
滸	氵 許
滺	氵 悠
滻	氵 産
滼	氵 梵
滽	氵 庸
滾	氵 袞
滿	氵 廿 冂 丨 入 入
漀	殸 水
漁	氵 魚
漃	氵 寂
漄	氵 崖
漅	氵 巢
漇	氵 徙
漊	氵 婁
漌	氵 堇
漍	氵 國
漎	氵 從
漐	執 水
漑	氵 旣
漒	氵 强
漗	氵 悤
漘	氵 脣
漙	氵 專
漚	氵 區
漛	氵 龹 水
漜	氵 埜
漝	氵 習
漞	氵 覓
漟	氵 堂
漡	氵 𠂉 昜
漢	氵 廿 口 夫
漣	氵 連
漥	氵 窐
漧	氵 乾
漨	氵 逢
漬	氵 責
漮	氵 康
漰	氵 崩
漲	氵 張
漵	氵 敘
漸	氵 斬
漺	氵 爽
漽	氵 犀
漿	將 水
潀	氵 眾
潁	匕 水 頁
潂	氵 山 並
潃	氵 彳 夂 月
潄	氵 敕
潅	氵 𠂉 一 隹
潈	氵 四 GQ
潉	氵 崑
潊	氵 敍
潌	氵 窒
潎	氵 敝
潐	氵 焦
潑	氵 發
潒	氵 象
潓	氵 惠
潔	氵 絜
潕	氵 無
潗	氵 集
潙	氵 爲
潚	氵 肅
潛	氵 朁
潝	氵 翕
潠	氵 巽
潡	氵 敦
潣	氵 閔
潤	氵 閏
潥	氵 粟
潧	氵 曾
潨	氵 衆
潪	氵 智
潫	氵 絭
潬	氵 單
潯	氵 尋
潰	氵 貴
潱	氵 壹
潳	氵 屠
潶	氵 黑
潷	氵 筆
潹	氵 森
潻	氵 黍
潿	氵 圍
澀	氵 歰
澁	氵 歮
澃	須 水
澅	氵 畫
澆	氵 堯
澇	氵 勞
澊	氵 尊
澋	氵 景
澏	氵 嵒
澐	氵 雲
澑	氵 畱
澒	氵 項
澓	氵 復
澔	氵 皓
澕	氵 華
澖	氵 閑
澗	氵 間
澘	氵 林 日
澙	氵 舃
澚	氵 NL 米 丂	# 右非“粤”
澝	氵 甯
澞	氵 虞
澟	氵 稟
澠	氵 黽
澢	氵 當
澣	氵 幹
澤	氵 睪
澦	氵 預
澨	氵 筮
澩	臼 爻 水
澫	氵 萬
澬	氵 資
澮	氵 會
澯	氵 粲
澰	氵 僉
澱	氵 殿
澲	氵 業
澵	氵 新
澷	氵 日 四 方
澸	氵 感
澺	氵 意
澻	氵 遂
澾	氵 達
澿	氵 禁
濁	氵 蜀
濃	氵 農
濄	氵 過
濅	氵 宀 帚 又
濆	氵 賁
濇	氵 嗇
濈	氵 戢
濊	氵 歲
濌	重 沓
濍	氵 葱
濎	氵 鼎
濏	氵 瑟
濐	氵 暑
濓	氵 亷
濔	氵 爾
濕	氵 㬎
濖	氵 署
濗	氵 幕
濘	氵 寧
濙	氵 熒
濚	氵 榮
濛	氵 蒙
濜	氵 盡
濝	氵 綦
濟	氵 齊
濢	氵 翠
濣	氵 斡
濤	氵 壽
濥	氵 夤
濦	氵 爪 工 彐 心
濧	氵 對
濨	氵 慈
濪	氵 靘
濫	氵 監
濬	氵 睿
濭	氵 蓋
濰	氵 維
濱	氵 賓
濲	氵 士 冖 禾 殳
濳	氵 先 先 日
濴	氵 滎
濵	氵 賔
濶	氵 門 舌
濷	水 滿
濸	氵 蒼
濹	氵 墨
濺	氵 賤
濻	氵 隤
濼	氵 樂
濽	氵 賛
濾	氵 慮
濿	氵 厲
瀀	氵 憂
瀁	氵 養
瀂	氵 魯
瀃	氵 賜
瀄	氵 節
瀅	氵 瑩
瀆	氵 賣
瀇	氵 廣
瀈	氵 翬
瀉	氵 寫
瀊	氵 盤
瀋	氵 審
瀎	氵 蔑
瀏	氵 劉
瀐	氵 韯
瀒	氵 來 一 回
瀓	氵 徵
瀕	氵 頻
瀖	氵 霍
瀗	氵 憲
瀘	氵 盧
瀙	氵 親
瀜	氵 融
瀝	氵 歷
瀞	氵 静
瀟	氵 蕭
瀠	氵 縈
瀡	氵 隨
瀢	氵 遺
瀤	氵 褱
瀥	氵 翯
瀦	氵 豬
瀧	氵 龍
瀨	氵 賴
瀩	氵 頽
瀪	敏 泉
瀫	氵 士 冖 一 糸 殳
瀬	氵 頼
瀭	氵 輸
瀮	氵 霖
瀯	氵 營
瀰	氵 彌
瀲	氵 斂
瀳	氵 薦
瀴	氵 嬰
瀶	氵 臨
瀷	氵 翼
瀸	氵 韱
瀺	氵 毚
瀻	氵 戴
瀽	氵 蹇
瀾	氵 闌
瀿	氵 繁
灀	氵 霜
灁	氵 闎
灂	氵 爵
灃	氵 豐
灄	氵 聶
灅	氵 壘
灆	氵 藍
灇	氵 叢
灉	氵 雝
灊	氵 鬵
灋	氵 廌 去
灍	氵 闕
灎	澧 盍
灐	氵 鎣
灑	氵 麗
灒	氵 贊
灓	龻 水
灔	氵 艶
灕	氵 離
灖	氵 靡
灗	氵 蟺
灘	氵 難
灙	氵 黨
灚	氵 覺
灛	氵 闡
灜	氵 贏
灝	氵 顥
灟	氵 屬
灠	氵 覽
灡	氵 蘭
灢	氵 囊
灣	氵 彎
灤	氵 欒
灥	泉 泉 泉
灦	氵 顯
灧	氵 艷
灨	氵 贛
灩	氵 豔
灪	氵 鬱
灮	火 儿
灱	火 刀
灲	火 刂
灳	勹 火
灴	火 工
灷	火 廾
灹	火 乇
灺	火 也
灻	土 火
災	巛 火
炁	旡 灬
炂	火 公
炃	分 火
炄	火 丑
炇	火 攵
炈	火 殳
炋	火 不
炍	火 反
炏	火 火
炐	火 丰
炑	火 木
炓	火 斗
炗	廿 火
炚	日 火
炛	火 化
炞	火 卞
炠	火 甲
炡	火 正
炢	火 术
炤	火 召
炥	火 弗
炦	火 犮
炧	火 𠂉 也
炨	火 它
炩	火 令
炪	火 出
炰	包 灬
炲	火 台
炴	火 央
炵	火 冬
炶	火 占
為	丷 乛 乛 𠃌 灬
炾	火 兄
炿	火 PY 亠	# 舟之形近
烄	火 交
烅	火 血
烆	火 行
烇	火 全
烉	⺈ LD 火
烋	休 灬
烌	火 休
烍	火 先
烎	开 火
烏	RZA
烐	火 舟
烑	火 兆
烒	火 式
烓	火 圭
烕	戌 火
烖	𢦏 火
烗	火 亥
烚	火 合
烞	火 朴
烡	火 共
烢	火 宅
烣	火 灰
烥	火 臣
烪	火 关
烮	列 火
烰	火 孚
烱	火 LD
烲	折 火
烳	火 甫
烴	火 巠
烵	火 芍
烸	火 每
烼	火 豕
烾	炎 土
烿	火 彤
焀	火 谷
焁	吹 火
焂	攸 火
焃	火 赤
焄	君 灬
焅	火 告
焇	火 肖
焈	戺 火
焋	壯 火
焍	火 弟
焎	折 灬
焏	了 叹 灬
焑	火 困
焒	火 吕
焔	火 ⺈ 旧
焛	門 火
焝	火 昏
焟	火 昔
焠	火 卒
無	𠂉 EA 灬
焢	火 空
焣	取 灬
焤	府 火
焥	火 宛
焧	火 忩
焨	火 冐
焩	火 朋
焪	火 穹
焫	火 芮
焬	火 易
焭	𤇾 几
焮	火 欣
焲	火 夜
焳	火 隹
焴	火 育
焵	火 LD
焷	火 卑
焸	昍 火
焹	火 LD
焺	火 昇
焻	火 昌
焼	火 尭
焽	明 火
焾	火 念
焿	火 庚
煀	火 屈
煂	火 革
煄	火 重
煆	火 叚
煇	火 軍
煈	火 風
煉	火 柬
煍	火 秋
煏	火 畐
煐	火 英
煑	者 火
煒	火 韋
煔	炎 占
煕	巸 灬
煖	火 爰
煗	火 耎
煘	火 咸
煙	火 垔
煚	昛 火
煛	目 目 火
煝	火 眉
煠	火 枼
煡	火 建
煢	𤇾 卂
煣	火 柔
煥	火 奐
煩	火 頁
煪	火 酋
煫	火 丷 豕
煬	火 昜
煭	巛 歹 刂 灬
煯	火 皆
煰	火 品
煱	火 咼
煵	火 南
煶	火 是
煷	火 亮
煹	火 冓
煻	火 唐
煼	火 芻
煾	火 恩
煿	火 尃
熀	火 晃
熁	火 脅
熂	火 氣
熃	務 火
熅	火 囚 皿
熆	火 盍
熈	丿 臣 巳 灬
熉	火 員
熋	能 火
熌	火 閃
熍	火 宫
熎	火 爪 缶
熐	火 冥
熑	火 兼
熒	𤇾 火
熓	火 烏
熕	火 貢
熖	火 舀
熗	火 倉
熚	火 畢
熝	火 鹿
熞	火 堅
熡	火 婁
熢	火 逢
熣	火 崔
熤	火 翌
熦	火 雀
熧	從 火
熩	火 扈
熪	火 移
熫	火 庶
熭	彗 火
熮	火 翏
熯	火 廿 口 夫
熰	火 區
熱	埶 灬
熲	匕 火 頁
熴	火 崑
熶	火 最
熷	火 曾
熸	火 朁
熺	火 喜
熼	火 異
熽	火 肅
熾	火 戠
熿	火 黄
燀	火 單
燁	火 華
燂	火 覃
燄	臽 炎
燅	坴 炎
燆	火 喬
燇	火 尊
燈	火 登
燉	火 敦
燌	火 賁
燍	火 斯
燐	火 粦
燑	火 童
燒	火 堯
燓	棥 火
燖	火 尋
燗	火 閒
燘	火 閔
燙	湯 火
燛	臦 火
燜	火 悶
燝	火 景
燞	隹 欠 灬
營	𤇾 吕
燡	火 睪
燢	臼 爻 火
燣	火 稟
燤	火 萬
燦	火 粲
燨	火 義
燩	火 敫
燪	火 葱
燫	火 廉
燬	火 毁
燭	火 蜀
燯	火 零
燰	火 愛
燱	火 意
燲	火 劦 貝
燳	火 照
燴	火 會
燵	火 達
燶	火 農
燷	火 禀
燸	火 需
燺	火 槀
燻	火 熏
燼	火 盡
燽	火 壽
燾	壽 灬
燿	火 翟
爀	火 赫
爁	火 監
爂	臼 同 火
爃	火 榮
爄	火 厲
爅	火 墨
爈	火 慮
爉	火 巤
爊	火 麃
爋	火 勳
爌	火 廣
爍	火 樂
爎	火 寮
爏	火 歷
爐	火 盧
爑	火 蕉
爒	炙 尞
爓	火 閻
爕	火 言 火 火
爖	火 龍
爗	火 曅
爘	火 餐
爙	火 襄
爛	火 闌
爜	火 叢
爞	火 蟲
爠	火 瞿
爡	火 蠆
爢	靡 灬
爣	火 黨
爤	火 蘭
爥	火 屬
爦	火 覽
爧	火 靈
爩	火 鬱
爫	PV	AAA
爭	爪 XB
爮	爪 包
爯	爪 冉
爲	爪 丿 乛 乛 𠃌 灬
爳	爲 了
爴	國 爪
爺	父 耶
爼	爻 且
爾	一 八 冂 丨 爻 爻
牀	爿 木
牃	爿 枼
牄	爿 倉
牅	爿 庸
牆	爿 嗇
牉	片 半
牊	片 召
牋	片 戔
牎	片 怱
牏	片 俞
牐	片 臿
牑	片 扁
牓	片 旁
牔	片 尃
牕	片 悤
牗	片 庸
牘	片 賣
牜	MB	AAA
牞	牛 力
牠	牛 也
牣	牛 刃
牨	牛 亢
牪	牛 牛
牫	牛 戈
牬	牛 丿 Z 丨 丿
牭	牛 四
牰	牛 由
牱	牛 可
牳	牛 母
牴	牛 氐
牶	龹 牛
牷	牛 全
牸	牛 字
牼	牛 巠
牽	亠 幺 冖 牛	# 特殊；幺 交
犂	禾 勹 丿 牛
犃	牛 咅
犅	牛 LD
犆	牛 直
犈	牛 卷
犉	牛 享
犌	牛 叚
犎	封 牛
犐	牛 科
犑	牛 狊
犓	牛 芻
犔	牛 氣
犕	牛 廿 丿 LD
犖	𤇾 牛
犗	牛 害
犘	麻 牛
犙	牛 參
犚	尉 牛
犛	未 攵 厂 牛
犜	牛 敦
犝	牛 童
犞	牛 喬
犠	牛 義
犡	牛 厲
犢	牛 賣
犣	牛 巤
犤	牛 罷
犥	牛 麃
犦	牛 暴
犧	牛 羲
犩	魏 牛
犪	牛 夔
犫	讎 牛
犮	友 丶
犱	犭 丸
犲	犭 才
犳	犭 勺
犵	犭 乞
犺	犭 亢
犻	犭 巿
犼	犭 孔
犽	犭 牙
犾	犭 犬
犿	犭 卞
狀	爿 犬
狅	犭 壬
狆	犭 中
狇	犭 木
狊	目 犬
狋	犭 示
狌	犭 生
狏	犭 𠂉 也
狑	犭 令
狓	犭 皮
狔	犭 尼
狕	犭 幼
狖	犭 穴
狘	犭 戉
狚	犭 旦
狛	犭 白
狜	犭 古
狟	犭 亘
狢	犭 各
狣	犭 兆
狤	犭 吉
狥	犭 旬
狦	犭 LD 二	# 特殊；似与“㹪”同
狧	犭 舌
狪	犭 同
狫	犭 老
狵	犭 尨
狶	犭 希
狹	犭 夾
狽	犭 貝
狾	犭 折
狿	犭 延
猀	犭 沙
猂	犭 旱
猅	犭 非
猆	非 犬
猈	犭 卑
猉	犭 其
猋	犬 犬 犬
猌	來 犬
猍	犭 來
猏	犭 肩
猐	犭 羌
猑	犭 昆
猒	日 月 犬
猔	犭 宗
猘	犭 制
猙	犭 爭
猚	犭 隹
猟	犭 鼡
猠	犭 典
猣	犭 凶 八 夂
猤	犭 癸
猦	犭 風
猧	犭 咼
猨	犭 爰
猭	犭 彖
猲	犭 曷
猳	犭 叚
猵	犭 扁
猶	犭 酋
猻	犭 孫
猼	犭 尃
猽	犭 冥
獀	犭 叟
獁	犭 馬
獂	犭 原
獃	豈 犬
獄	犭 言 犬
獅	犭 師
獆	犭 皋
獇	犭 羗
獈	犭 益
獉	犭 秦
獊	犭 倉
獋	犭 臯
獌	犭 曼
獎	將 犬
獏	犭 莫
獑	犭 斬
獓	犭 敖
獔	犭 皐
獕	犭 崔
獖	犭 賁
獘	敝 犬
獙	犭 敝
獚	犭 黄
獛	犭 菐
獜	犭 粦
獝	犭 矞
獞	犭 童
獟	犭 堯
獡	犭 舄
獢	犭 喬
獣	畄 一 口 犬
獤	犭 敦
獥	犭 敫
獦	犭 葛
獧	犭 睘
獨	犭 蜀
獩	犭 歲
獪	犭 會
獫	犭 僉
獮	犭 爾
獰	犭 寧
獱	犭 賓
獲	犭 蒦
獳	犭 需
獵	犭 巤
獶	犭 憂
獷	犭 廣
獸	嘼 犬
獹	犭 盧
獺	犭 賴
獻	鬳 犬
獼	犭 彌
獽	犭 襄
獿	犭 夒
玀	犭 羅
玁	犭 嚴
玂	犭 蘄
玅	玄 少
玆	玄 玄
玈	玄 𠂉 氏
玊	王 丶
玌	王 乚
玍	𠂉 土
玏	王 力
玐	王 八
玔	王 川
玗	王 于
玜	王 公
玝	王 午
玣	王 卞
玧	王 允
玨	王 王
玪	王 今
玬	王 丹
玴	王 世
玵	王 甘
玸	王 包
玽	王 句
玾	王 甲
珁	王 瓦
珃	王 冉
珄	王 生
珆	王 台
珎	王 尔
珓	王 交
珔	王 存
珗	王 先
珘	王 舟
珚	王 因
珜	王 羊
珟	王 夙
珡	玨 人
珤	王 缶
珨	王 合
珬	王 戌
珮	王 QD 帀
珯	王 老
珱	王 VD 女
珳	王 彣
珴	王 我
珶	王 弟
珻	王 每
珼	王 貝
現	王 見
珿	王 足
琁	王 𠂉 疋
琂	王 言
琋	王 希
琌	王 岑
琍	王 利
琑	王 肖
琒	王 夆
琓	王 完
琕	王 卑
琖	王 戔
琗	王 卒
琘	王 昏
琙	王 或
琜	王 來
琝	王 旻
琞	明 玉
琠	王 典
琣	王 咅
琧	亞 玉
琩	王 昌
琱	王 周
琷	王 羌
琸	王 卓
琹	玨 木
琺	王 法
琻	王 金
琽	王 者
琾	王 界
琿	王 軍
瑇	王 毒
瑈	王 柔
瑉	王 昬
瑊	王 咸
瑋	王 韋
瑌	王 耎
瑍	王 奐
瑎	王 皆
瑏	王 穿
瑐	王 前
瑒	王 昜
瑘	王 耶
瑠	王 留
瑡	王 師
瑣	王 小 貝
瑤	王 RS 缶	# 非“瑶”
瑥	王 昷
瑦	王 烏
瑩	𤇾 玉
瑪	王 馬
瑫	王 舀
瑮	王 栗
瑯	王 郎
瑲	王 倉
瑴	士 冖 一 王 殳
瑵	王 蚤
瑸	王 宾
瑹	王 荼
瑺	王 常
瑻	王 貫
瑼	王 專
瑽	王 從
瑿	殹 玉
璂	王 基
璄	王 竟
璅	王 巢
璉	王 連
璊	王 廿 冂 丨 入 入
璌	王 寅
璍	王 華
璏	王 彘
璑	王 無
璓	王 莠
璔	王 曾
璕	王 尋
璖	王 渠
璗	湯 玉
璙	王 尞
璚	王 矞
璛	王 肅
璝	王 貴
璡	王 進
璢	王 畱
璣	王 幾
璤	王 惠
璦	王 愛
璫	王 當
璭	王 運
璯	王 會
環	王 睘
璳	王 朱 貝
璴	王 楚
璵	王 與
璶	王 盡
璷	王 敷
璸	王 賓
璹	王 壽
璻	王 翠
璼	王 監
璽	爾 玉
璾	王 齊
璿	王 睿
瓁	王 蒦
瓂	王 蓋
瓃	王 畾
瓄	王 賣
瓅	王 樂
瓆	王 質
瓇	王 憂
瓈	王 黎
瓉	王 賛
瓊	王 夐
瓋	王 適
瓌	王 褱
瓍	王 隨
瓎	王 賴
瓏	王 龍
瓐	王 盧
瓑	王 歷
瓓	王 闌
瓔	王 嬰
瓕	彌 玉
瓗	王 巂
瓙	王 燾
瓚	王 贊
瓛	王 獻
瓝	瓜 勺
瓟	瓜 包
瓡	幸 瓜
瓥	瓜 豕 虫 虫
瓧	瓦 十
瓨	工 瓦
瓩	瓦 千
瓪	瓦 反
瓫	分 瓦
瓬	方 瓦
瓭	冘 瓦
瓰	瓦 分
瓱	瓦 毛
瓳	古 瓦
瓵	台 瓦
瓸	瓦 百
瓹	肙 瓦
瓺	镸 瓦
瓼	瓦 里
瓽	龸 口 瓦
瓾	委 瓦
甀	垂 瓦
甁	幷 瓦
甂	扁 瓦
甃	秋 瓦
甅	瓦 厘
甆	兹 瓦
甇	𤇾 瓦
甈	臬 瓦
甉	兼 瓦
甊	婁 瓦
甋	啇 瓦
甌	區 瓦
甎	專 瓦
甐	粦 瓦
甒	無 瓦
甔	詹 瓦
甕	雍 瓦
甖	賏 瓦
甛	甘 舌
甝	虎 甘
甞	龸 口 甘
甠	日 生
產	文 厂 生
産	立 丿 生
甤	豕 生
甧	甡 月
甮	勿 LD
甴	日 丨
甶	丿 田
甹	由 丂
甼	田 丁
甽	田 川
甿	田 亡
畁	由 丌
畂	田 久
畃	申 勺
畄	VD 田
畆	亩 厶
畇	田 匀
畉	田 夫
畊	田 井
畍	田 介
畐	一 口 田
畑	火 田
畒	亩 人
畓	水 田
畕	田 田
畗	亠 口 田
畘	田 冉
畝	亩 久
畞	十 田 久
畟	田 八 夂
畠	白 田
畡	田 亥
畢	日 艹 BI	# 日 交
畣	合 田
畧	田 各
畨	米 田
畩	田 衣
畫	XB 田 一
畭	田 余
畮	田 每
異	田 共
畱	一 KD 匚 X 田
畳	田 冝
畵	XB 一 田 凵
當	龸 口 田
畷	田 叕
畺	三 田 田
畻	田 龹 土
畼	田 昜
畽	田 重
畾	田 田 田
疀	甾 疌
疂	田 V 冝
疄	田 粦
疅	田 畺
疇	田 壽
疈	畐 UD 畐
疉	畾 冖 彑	#** 下从彑不从“夕一”
疊	畾 冝
疌	一 彐 止	# 彐 交
疎	⺪ 束
疓	疒 乃
疕	疒 匕
疘	疒 工
疛	疒 寸
疜	疒 下
疞	疒 亏
疦	疒 夬
疧	疒 氏
疨	疒 牙
疩	疒 卆
疪	疒 比
疶	疒 世
疷	疒 氐
疺	疒 乏
疻	疒 只
疿	疒 弗
痀	疒 句
痁	疒 占
痆	疒 尼
痋	疒 虫
痌	疒 同
痎	疒 亥
痏	疒 有
痐	疒 回
痑	疒 多
痗	疒 每
痙	疒 巠
痚	疒 孝
痜	疒 秃
痝	疒 尨
痟	疒 肖
痠	疒 夋
痡	疒 甫
痥	疒 兑
痩	疒 申 又	# 日 交；非“瘦”
痬	疒 易
痭	疒 朋
痮	疒 長
痯	疒 官
痲	疒 木 木	# 非“痳”
痳	疒 林	# 非“痲”
痵	疒 季
痶	疒 典
痷	疒 奄
痸	疒 制
痺	疒 卑
痻	疒 昏
痽	疒 隹
痾	疒 阿
瘂	疒 亞
瘄	疒 昔
瘇	疒 重
瘈	疒 契
瘉	疒 俞
瘋	疒 風
瘍	疒 昜
瘎	疒 甚
瘏	疒 者
瘑	疒 咼
瘒	疒 軍
瘓	疒 奐
瘔	疒 苦
瘖	疒 音
瘚	疒 欮
瘜	疒 息
瘝	疒 眔
瘞	疒 夾 土
瘡	疒 倉
瘣	疒 鬼
瘧	疒 虐
瘨	疒 真
瘬	疒 張
瘮	疒 參
瘯	疒 族
瘱	疒 夾 心
瘲	疒 從
瘶	疒 欶
瘷	疒 敕
瘹	疒 釣
瘺	疒 屚
瘻	疒 婁
瘽	疒 堇
癁	疒 復
療	疒 尞
癄	疒 焦
癅	疒 畱
癆	疒 勞
癇	疒 閒
癈	疒 發
癉	疒 單
癊	疒 陰
癋	疒 惡
癎	疒 間
癏	疒 睘
癐	疒 會
癑	疒 農
癒	疒 愈
癓	疒 微
癕	疒 雍
癘	疒 萬
癙	疒 鼠
癚	疒 詹
癛	疒 稟
癝	疒 禀
癟	疒 自 侖
癠	疒 齊
癡	疒 疑
癢	疒 養
癤	疒 節
癥	疒 徵
癦	疒 墨
癧	疒 歷
癨	疒 霍
癩	疒 賴
癪	疒 積
癬	疒 鮮
癭	疒 嬰
癮	疒 隱
癰	疒 雝
癱	疒 難
癲	疒 顛
癳	疒 纍
癴	疒 攣
癵	疒 臠
癷	癶 干
癹	癶 殳
発	癶 一 一 儿	#** 特殊
發	癶 弓 殳
皀	白 匕
皁	白 十
皃	白 儿
皅	白 巴
皉	白 此
皊	白 令
皌	白 末
皍	白 匕 卩
皏	白 并
皐	白 V 十
皒	白 我
皔	白 旱
皗	白 周
皘	白 青
皚	白 豈
皜	白 高
皝	皇 光
皟	白 責
皠	白 崔
皡	白 皐
皢	白 堯
皣	白 華
皥	白 臯
皧	白 愛
皨	皛 土
皩	皇 晃
皪	白 樂
皫	白 麃
皬	白 霍
皯	皮 干
皰	皮 包
皳	求 皮
皵	昔 皮
皶	查 皮
皷	壴 皮
皸	軍 皮
皹	皮 軍
皺	芻 皮
皻	虘 皮
皼	壹 皮
皽	亶 皮
皾	賣 皮
盀	卜 皿
盁	乃 皿
盃	不 皿
盄	弔 皿
盇	太 皿
盋	犮 皿
盌	夗 皿
盓	汙 皿
盕	汎 皿
盙	甫 皿
盚	求 皿
盜	氵 欠 皿
盝	录 皿
盞	戔 皿
盠	彖 皿
盡	⺻ 灬 皿
盢	畎 皿
監	臣 M 皿
盤	般 皿
盧	虍 田 皿
盨	須 皿
盩	幸 攵 皿
盪	湯 皿
盫	合 酉 皿
盬	臣 𠂉 古 皿
盭	幺 幸 攵 皿
盰	目 干
盳	目 亡
盵	目 乞
盶	目 元
盺	目 斤
盻	目 兮
盽	目 丰
盿	目 文
眀	目 月
眂	目 氏
眃	目 云
眅	目 反
眆	目 方
県	目 Z 小	# 特殊
眎	目 示
眏	目 央
眐	目 正
眑	目 幼
眒	目 申
眓	目 戉
眔	四 水
眕	目 人 彡
眖	目 兄
眗	目 句
眘	大 丷 目
眛	目 未
眜	目 末
眝	目 宁
眞	匕 目 Z 八	# 特殊
眡	目 氐
眣	目 失
眤	目 尼
眥	此 目
眧	目 召
眪	目 丙
眫	目 半
眮	目 同
眰	目 至
眱	目 夷
眲	目 耳
眳	目 名
眴	目 旬
眹	目 关
眻	目 羊
眽	目 ⺁ 氏
眾	四 亻 人 人
眿	目 永
睂	仌 丨 厂 目
睅	目 旱
睆	目 完
睈	目 呈
睉	目 坐
睊	目 肙
睋	目 我
睌	目 免
睍	目 見
睏	目 困
睒	目 炎
睓	目 典
睔	目 侖
睕	目 宛
睖	目 夌
睗	目 易
睘	四 一 口 氏
睙	目 戾
睜	目 爭
睝	禾 勹 丿 目
睞	目 來
睟	目 卒
睠	目 卷
睤	目 畀
睧	目 昏
睩	目 录
睪	四 幸
睭	目 周
睮	目 俞
睯	敃 目
睰	目 若
睱	目 叚
睲	目 星
睳	目 奎
睴	目 軍
睵	目 哉
睶	目 春
睷	目 建
睸	目 眉
睺	目 侯
睻	目 宣
睼	目 是
瞁	目 狊
瞂	盾 犮
瞃	目 盾
瞆	目 贵
瞇	目 迷
瞈	目 翁
瞉	士 冖 一 目 殳
瞊	目 唐
瞏	四 袁
瞐	目 目 目
瞓	目 訓
瞔	目 責
瞕	目 章
瞖	殹 目
瞗	目 鳥
瞘	目 區
瞙	目 莫
瞚	目 寅
瞛	目 從
瞜	目 婁
瞝	目 离
瞞	目 廿 冂 丨 入 入
瞡	目 規
瞣	目 患
瞤	目 閏
瞦	目 喜
瞨	目 菐
瞮	目 育 攵
瞯	目 閒
瞱	目 華
瞲	目 矞
瞴	目 無
瞶	目 貴
瞷	目 間
瞸	目 葉
瞹	目 愛
瞺	目 會
瞼	目 僉
瞾	目 目 空
矀	目 微
矁	目 愁
矂	目 喿
矃	目 寧
矄	目 熏
矅	目 翟
矆	目 蒦
矇	目 蒙
矈	目 白 穴 方	# 右非“臱”
矉	目 賓
矊	目 綿
矋	目 厲
矌	目 廣
矎	目 夐
矏	目 臱
矐	目 霍
矑	目 盧
矒	目 瞢
矓	目 龍
矔	目 雚
矕	龻 目
矖	目 麗
矘	目 黨
矙	目 闞
矚	目 屬
矝	矛 令
矟	矛 肖
矠	矛 昔
矡	矛 矍
矤	弓 矢
矦	厃 矢
矨	矢 夭
矪	矢 舟
矯	矢 喬
矱	矢 蒦
矲	矢 罷
矴	石 丁
矵	石 刂
矷	石 子
矹	石 兀
矺	石 乇
砃	石 丹
砅	石 水
砇	石 文
砈	石 厄
砊	石 亢
砋	石 止
砎	石 介
砏	石 分
砐	石 及
砓	石 殳
砕	石 卆
砙	石 瓦
砛	石 今
砞	石 末
砡	石 玉
砢	石 可
砤	石 𠂉 也
砨	石 戹
砪	石 母
砯	石 氷
砱	石 令
砲	石 包
砳	石 石
砶	石 白
砽	石 LD
砿	石 広
硂	石 全
硃	石 朱
硄	石 光
硆	石 合
硈	石 吉
硉	石 聿
硋	石 亥
硏	石 幵
硑	石 并
硓	石 老
硘	石 回
硛	石 亦
硜	石 巠
硞	石 告
硟	石 延
硠	石 良
硡	石 宏
硢	石 余
硣	石 孝
硤	石 夾
硥	石 尨
硦	石 弄
硧	石 甬
硨	石 車
硩	折 石
硯	石 見
硰	沙 石
硱	石 困
硲	石 谷
硳	石 赤
硴	石 花
硵	石 卤
硶	石 岑
硸	石 岸
硹	石 松
硺	石 豖
硻	臤 石
硽	石 奄
硾	石 垂
碀	石 争
碁	其 石
碂	石 宗
碄	石 林
碅	石 囷
碆	波 石
碊	石 戔
碋	石 岢
碐	石 夌
碒	石 金
碔	石 武
碕	石 奇
碖	石 侖
碙	石 LD
碝	石 耎
碞	品 石
碠	石 亭
碢	石 咼
碤	石 英
碦	石 客
碩	石 頁
碪	石 甚
碫	石 段
碬	石 叚
碭	石 昜
碮	石 是
碯	石 巛 囟
碵	石 貞
碷	石 盾
碸	石 風
確	石 隺
碻	石 高
碼	石 馬
碽	石 貢
碿	石 屑
磀	石 逆
磂	石 留
磃	石 虒
磄	石 唐
磆	石 骨
磇	石 囟 比
磈	石 鬼
磌	石 真
磍	石 害
磎	石 奚
磑	石 豈
磒	石 員
磓	石 追
磖	石 習
磗	石 尃
磘	石 爪 缶
磚	石 專
磛	斬 石
磝	石 敖
磞	石 崩
磟	石 翏
磠	石 鹵
磢	石 爽
磣	石 參
磤	石 殷
磥	石 累
磦	石 票
磧	石 責
磩	石 戚
磪	石 崔
磫	石 從
磭	石 脣
磮	石 崙
磯	石 幾
磰	石 善
磱	石 勞
磳	石 曾
磵	石 間
磶	石 舄
磸	石 奠
磼	石 集
磽	石 堯
磾	石 單
磿	厤 石
礀	石 閒
礂	石 喜
礃	石 掌
礄	石 喬
礆	石 僉
礇	石 奥
礈	石 遂
礉	石 敫
礊	車 凵 殳 石
礋	石 睪
礍	石 葛
礎	石 楚
礏	石 業
礐	臼 爻 石
礑	石 當
礒	石 義
礔	石 辟
礕	辟 石
礖	石 與
礗	石 賓
礘	石 㬎
礙	石 疑
礚	石 蓋
礛	石 監
礜	與 石
礝	石 需
礟	石 駁
礠	石 慈
礡	石 蒪
礢	石 養
礣	石 蔑
礥	石 賢
礦	石 廣
礧	石 畾
礨	畾 石
礩	石 質
礪	石 厲
礫	石 樂
礬	樊 石
礭	石 霍
礮	石 駮
礯	石 縈
礰	石 歷
礱	龍 石
礲	石 龍
礳	石 磨
礶	石 雚
礷	石 藍
礸	石 贊
礹	石 嚴
礽	礻 乃
礿	礻 勺
祂	礻 也
祄	礻 介
祅	礻 夭
祌	礻 中
祍	礻 壬
祑	礻 失
祒	礻 召
祔	礻 付
祘	示 示
祙	礻 未
祡	此 示
祣	礻 𠂉 氏
祤	礻 羽
祦	礻 吴
祩	礻 朱
祪	礻 危
祫	礻 合
祬	礻 至
祮	礻 吉
祰	礻 告
祱	礻 兑
祳	礻 辰
祴	礻 戒
祵	礻 困
祶	礻 弟
祹	礻 匋
祻	礻 固
祽	礻 卒
祿	礻 彔
禂	礻 周
禃	礻 直
禆	礻 卑
禇	礻 者
禈	礻 軍
禉	礻 酋
禌	礻 兹
禍	礻 咼
禎	礻 貞
禐	礻 爰
禑	礻 禺
禓	礻 昜
禕	礻 韋
禖	礻 某
禗	礻 思
禙	礻 背
禜	𤇾 示
禝	礻 畟
禞	礻 高
禟	礻 唐
禠	礻 虒
禡	礻 馬
禢	礻 日 羽
禣	礻 尃
禥	礻 基
禦	御 示
禨	礻 幾
禩	礻 異
禪	礻 單
禫	礻 覃
禬	礻 會
禭	礻 遂
禮	礻 豊
禯	礻 農
禰	礻 爾
禱	礻 壽
禲	礻 厲
禴	礻 龠
禵	礻 題
禶	礻 贊
禷	礻 類
禸	冂 厶	# 冂 交
禼	卤 禸
禿	禾 儿
秂	禾 人
秄	禾 子
秅	禾 乇
秇	禾 丸
秈	禾 山
秊	禾 千
秌	火 禾
秎	禾 分
秏	禾 毛
秐	禾 云
秓	禾 支
秔	禾 亢
秖	禾 氏
秗	禾 夭
秙	禾 古
秚	禾 半
秛	禾 皮
秜	禾 尼
秝	禾 禾
秞	禾 由
秠	禾 丕
秡	禾 犮
秢	禾 令
秥	禾 占
秨	禾 乍
秪	禾 氐
秮	禾 台
秱	禾 同
秲	禾 寺
秳	禾 舌
秴	禾 合
秵	禾 因
秶	次 禾
秷	禾 至
秹	禾 任
秺	禾 宅
秼	禾 朱
秿	禾 甫
稁	亠 口 冖 禾
稄	禾 夋
稅	禾 兌
稇	禾 困
稈	禾 旱
稉	禾 更
稊	禾 弟
稏	禾 亞
稐	禾 侖
稒	禾 固
稓	禾 昔
稕	禾 享
稖	禾 咅
稘	禾 其
稛	禾 囷
稜	禾 夌
稝	禾 朋
稟	亠 回 禾
稡	禾 卒
稢	禾 或
稤	禾 京
稥	禾 灬 日
稦	禾 韋
稧	禾 契
稨	禾 扁
稩	禾 胃
稪	禾 复
稫	禾 畐
稬	禾 耎
稭	禾 皆
種	禾 重
稯	禾 凶 八 夂
稰	禾 胥
稱	禾 爯
稲	禾 爪 旧
稴	禾 兼
稵	禾 兹
稶	禾 彧
稸	禾 畜
稺	禾 屖
稾	高 禾
穀	士 冖 一 禾 殳
穁	禾 茸
穂	禾 恵
穃	禾 容
穅	禾 康
穇	禾 參
穈	麻 禾
穉	禾 犀
穊	禾 既
穋	禾 翏
穌	魚 禾
積	禾 責
穎	匕 禾 頁
穏	禾 爪 彐 心
穐	禾 亀
穒	禾 鳥
穓	禾 異
穔	禾 黄
穕	禾 集
穖	禾 幾
穘	禾 堯
穚	禾 喬
穛	禾 焦
穝	禾 最
穞	禾 鲁
穠	禾 農
穡	禾 嗇
穢	禾 歲
穣	禾 六 甘 氏
穤	禾 需
穥	禾 與
穦	禾 賓
穧	禾 齊
穨	秃 貴
穩	禾 爪 工 彐 心
穪	禾 爾
穫	禾 蒦
穬	禾 廣
穭	禾 魯
穮	禾 麃
穯	禾 土 口 口 回
穱	禾 爵
穲	禾 麗
穳	禾 贊
穵	穴 乙
穻	穴 于
穼	穴 木
穽	穴 井
穾	穴 夭
窂	穴 牛
窇	穴 包
窉	穴 丙
窋	穴 出
窌	穴 卯
窏	穴 汙
窐	穴 圭
窓	穴 厶 心
窔	穴 交
窙	穴 孝
窚	穴 成
窛	穴 元 女
窞	穴 臽
窡	穴 叕
窢	穴 或
窤	穴 昆
窧	穴 卓
窩	穴 咼
窪	穴 洼
窫	穴 契
窮	穴 躬
窯	穴 羔
窰	穴 爪 缶
窱	穴 條
窲	穴 料
窴	穴 真
窵	穴 鳥
窶	穴 婁
窷	穴 聊
窹	穴 爿 吾
窺	穴 規
窻	穴 悤
窼	穴 巢
窽	穴 欵
窾	穴 款
竀	穴 正 見
竁	穴 毳
竂	穴 尞
竃	穴 土 日 电	# 日 交
竄	穴 鼠
竅	穴 敫
竆	穴 躳
竇	穴 賣
竈	穴 土 黽
竉	穴 龍
竊	穴 釆 卜 LD 冂 厶
竌	立 几
竍	立 十
竎	立 廾
竏	立 千
竐	立 殳
竒	亠 丷 可	# 特殊：为何不是 立 口 丨？
竓	立 毛
竔	立 升
竕	立 分
竗	立 少
竚	立 宁
竛	立 令
竜	立 日 乚	# 日 交
竝	立 立
竡	立 百
竢	立 矣
竤	立 宏
竧	立 身
竨	立 卓
竩	立 宜
竪	臤 立
竬	立 禹
竮	立 屏
竰	立 厘
竱	立 專
竲	立 曾
竳	立 登
竴	立 尊
竵	立 一 口 MB LD
競	竞 竞
竷	章 夅 夂
竸	竟 竟
竻	⺮ 力
竼	⺮ 凡
竾	⺮ 也
笀	⺮ 亡
笁	⺮ 工
笂	⺮ 丸
笅	⺮ 爻
笇	⺮ 卞
笉	⺮ 匀
笌	⺮ 牙
笍	⺮ 内
笎	⺮ 元
笐	⺮ 亢
笒	⺮ 今
笓	⺮ 比
笖	⺮ 以
笗	⺮ 冬
笘	⺮ 占
笚	⺮ 甲
笜	⺮ 出
笝	⺮ 囗 又
笟	⺮ 瓜
笡	⺮ 且
笢	⺮ 民
笣	⺮ 包
笧	⺮ 册
笩	⺮ 代
笭	⺮ 令
笰	⺮ 弗
笲	⺮ 弁
笴	⺮ 可
笵	⺮ 氾
笶	⺮ 矢
笷	⺮ 卯
笹	⺮ 世
笻	⺮ 卭
笽	⺮ 皿
笿	⺮ 各
筁	⺮ 曲
筂	⺮ 池
筃	⺮ 因
筄	⺮ 兆
筆	⺮ 聿
筈	⺮ 舌
筊	⺮ 交
筍	⺮ 旬
筎	⺮ 如
筓	⺮ 幵
筕	⺮ 行
筗	⺮ 仲
筙	⺮ 耒
筞	⺮ 宋
筟	⺮ 孚
筡	⺮ 余
筣	⺮ 利
筧	⺮ 見
筨	⺮ 含
筩	⺮ 甬
筪	⺮ 匣
筫	⺮ 貝
筬	⺮ 成
筭	⺮ 弄
筯	⺮ 助
筰	⺮ 作
筳	⺮ 廷
筴	⺮ 夾
筸	⺮ 旱
筺	⺮ 匤
筽	⺮ 吴
筿	⺮ 条
箁	⺮ 咅
箂	⺮ 來
箃	⺮ 取
箄	⺮ 卑
箆	⺮ LD 比
箇	⺮ 固
箈	⺮ 治
箉	⺮ 拐
箊	⺮ 於
箋	⺮ 戔
箌	⺮ 到
箎	⺮ 虎
箏	⺮ 爭
箑	⺮ 疌
箒	⺮ 帚
箘	⺮ 囷
箙	⺮ 服
箚	⺮ 合 刂
箛	⺮ 孤
箞	⺮ 卷
箟	⺮ 昆
箠	⺮ 垂
箣	⺮ 刺
箤	⺮ 卒
箥	⺮ 波
箮	⺮ 宣
箯	⺮ 便
箰	筍 子
箲	⺮ 洗
箳	⺮ 屏
箵	⺮ 省
箶	⺮ 胡
箷	⺮ 施
箹	⺮ 約
箺	⺮ 春
箻	⺮ 律
箼	⺮ 屋
箽	⺮ 重
箾	⺮ 削
箿	⺮ 咠
節	⺮ 即
篂	⺮ 星
篃	⺮ 眉
範	⺮ 車 ⺋
篅	⺮ 耑
篈	⺮ 封
築	筑 木
篊	⺮ 洪
篋	⺮ 匧
篍	⺮ 秋
篎	⺮ 眇
篏	⺮ 甘 欠
篐	⺮ 木 匝
篒	⺮ 食
篔	⺮ 員
篕	⺮ 盍
篖	⺮ 唐
篗	⺮ 隻
篘	⺮ 芻
篛	⺮ 弱
篜	⺮ 烝
篞	⺮ 涅
篟	⺮ 倩
篠	⺮ 條
篢	⺮ 貢
篣	⺮ 旁
篤	⺮ 馬
篧	⺮ 隺
篨	⺮ 除
篩	⺮ 師
篫	筑 手
篬	⺮ 倉
篭	⺮ 竜
篰	⺮ 部
篲	⺮ 彗
篳	⺮ 畢
篴	⺮ 逐
篵	⺮ 從
篶	⺮ 焉
篸	⺮ 參
篹	⺮ 目 大 ⺋
篺	⺮ 捭
篻	⺮ 票
篽	⺮ 御
篿	⺮ 專
簀	⺮ 責
簁	⺮ 徙
簂	⺮ 國
簄	⺮ 扈
簅	⺮ 産
簆	⺮ 宀 元 攴
簈	⺮ 屛
簊	⺮ 基
簍	⺮ 婁
簎	⺮ 措
簐	⺮ 軟
簑	⺮ 衰
簒	⺮ 目 大 么
簓	⺮ 彫
簔	⺮ 亠 二 艹 氏	# 非“簑”
簗	⺮ 梁
簘	⺮ 粛
簙	⺮ 博
簚	⺮ 四 戈 巾
簛	⺮ 斯
簜	⺮ 湯
簞	⺮ 單
簡	⺮ 間
簢	⺮ 閔
簣	⺮ 貴
簤	⺮ 買
簥	⺮ 喬
簨	⺮ 巽
簩	⺮ 勞
簫	⺮ 肅
簬	⺮ 路
簭	筮 八 口
簮	⺮ 替
簯	⺮ 棋
簱	⺮ 方 其
簲	⺮ 脾
簳	⺮ 幹
簴	⺮ 虡
簵	⺮ 輅
簶	⺮ 禄
簷	⺮ 詹
簹	⺮ 當
簺	⺮ 塞
簻	⺮ 過
簼	⺮ 搆
簽	⺮ 僉
簾	⺮ 廉
籂	⺮ 飾
籃	⺮ 監
籄	⺮ 匱
籅	⺮ 與
籆	⺮ 蒦
籇	⺮ 豪
籈	⺮ 甄
籉	⺮ 臺
籊	⺮ 翟
籋	⺮ 爾
籌	⺮ 壽
籎	⺮ 疑
籏	⺮ 旗
籐	⺮ 滕
籑	⺮ 目 大 良
籒	⺮ 扌 畱
籓	⺮ 潘
籔	⺮ 數
籕	⺮ 榴
籖	⺮ 韯
籗	⺮ 霍
籘	⺮ 縢
籙	⺮ 録
籚	⺮ 盧
籛	⺮ 錢
籜	⺮ 擇
籝	⺮ 嬴
籞	⺮ 禦
籟	⺮ 賴
籠	⺮ 龍
籡	⺮ 撿
籢	⺮ 斂
籣	⺮ 闌
籤	⺮ 韱
籦	⺮ 鍾
籧	⺮ 遽
籨	⺮ 歛
籩	⺮ 邊
籪	⺮ 斷
籫	⺮ 贊
籬	⺮ 離
籭	⺮ 麗
籮	⺮ 羅
籯	⺮ 贏
籰	⺮ 矍
籱	⺮ 靃
籲	⺮ 龥
籵	米 十
籶	米 几
籷	米 乇
籸	米 卂
籹	米 女
籺	米 乞
籾	米 刃
籿	米 寸
粀	米 丈
粁	米 千
粂	久 米
粃	米 比
粄	米 反
粅	米 勿
粆	米 少
粇	米 亢
粈	米 丑
粊	比 米
粋	米 卆
粌	米 引
粍	米 毛
粎	米 尺
粏	米 太
粐	米 户
粓	米 甘
粔	米 巨
粖	米 末
粙	米 由
粚	米 𠂉 也
粛	彐 ND 米	# 彐 交
粠	米 共
粡	米 同
粣	米 册
粦	米 舛
粧	米 庄
粨	米 百
粩	米 老
粫	米 而
粬	米 曲
粭	米 合
粯	米 見
粰	米 孚
粴	米 里
粵	NJ 釆 丂
粶	米 录
粷	米 匊
粸	米 其
粺	米 卑
粻	米 長
糀	米 花
糂	米 甚
糃	米 昜
糄	米 扁
糆	米 面
糉	米 凶 八 夂
糋	米 前
糎	米 厘
糏	米 屑
糐	米 尃
糑	米 弱
糓	士 冖 一 米 殳
糔	米 蚤
糘	米 家
糚	米 莊
糛	米 堂
糝	米 參
糞	米 異
糡	米 竟
糢	米 莫
糣	米 朁
糤	米 散
糥	米 而 而
糦	米 喜
糧	米 量
糩	米 會
糪	辟 米
糫	米 睘
糬	米 署
糭	米 OS 凵 八 夂
糮	米 監
糰	米 團
糱	辥 米
糲	米 厲
糳	丵 臼 殳 米
糴	籴 翟
糶	粜 翟
糷	米 蘭
糺	糹 乚
糼	糹 力
糽	糹 丁
糾	糹 丩
糿	糹 刀
紀	糹 己
紁	糹 叉
紂	糹 寸
紃	糹 川
約	糹 勺
紅	糹 工
紆	糹 于
紇	糹 乞
紈	糹 丸
紉	糹 刃
紋	糹 文
紌	糹 尤
納	糹 内
紎	糹 犬
紏	糹 斗
紐	糹 丑
紑	糹 不
紒	糹 介
紓	糹 予
純	糹 屯
紕	糹 比
紖	糹 引
紗	糹 少
紘	糹 厷
紙	糹 氏
級	糹 及
紛	糹 分
紜	糹 云
紝	糹 壬
紞	糹 冘
紟	糹 今
紡	糹 方
紣	糹 卆
紤	糹 斤
紥	扎 糸
紦	糹 巴
紨	糹 付
紩	糹 失
紪	糹 此
紬	糹 由
紭	糹 弘
紮	札 糸
細	糹 田
紱	糹 犮
紲	糹 世
紳	糹 申
紴	糹 皮
紵	糹 宁
紶	糹 去
紷	糹 令
紸	糹 主
紹	糹 召
紺	糹 甘
紻	糹 央
紼	糹 弗
紽	糹 它
紾	糹 人 彡
紿	糹 台
絀	糹 出
絁	糹 𠂉 也
終	糹 冬
絃	糹 玄
組	糹 且
絅	糹 LD
絆	糹 半
絇	糹 句
絈	糹 白
絉	糹 术
絊	糹 本
絋	糹 広
経	糹 圣
絍	糹 任
絎	糹 行
絏	糹 曳
結	糹 吉
絑	糹 朱
絒	糹 州
絓	糹 圭
絔	糹 百
絕	糹 刀 巴
絖	糹 光
絗	糹 回
絘	糹 次
絙	糹 亘
絚	糹 亙
絛	亻 丨 夂 糸
絝	糹 夸
絞	糹 交
絟	糹 全
絠	糹 有
絡	糹 各
絢	糹 旬
絣	糹 并
絤	糹 西
絥	糹 伏
給	糹 合
絧	糹 同
絨	糹 戎
絩	糹 兆
絪	糹 因
絫	厽 糸
絬	糹 舌
絭	龹 糸
絯	糹 亥
絰	糹 至
統	糹 充
絲	糹 糸
絳	糹 夅
絴	糹 羊
絵	糹 会
絶	糹 色
絸	糹 見
絹	糹 肙
絺	糹 希
絻	糹 免
絼	糹 豸
絽	糹 吕
絾	糹 成
絿	糹 求
綀	糹 束
綁	糹 邦
綂	糹 亠 兄
綃	糹 肖
綄	糹 完
綅	糹 彐 冖 又
綆	糹 更
綇	糹 酉
綈	糹 弟
綉	糹 秀
綊	糹 夾
綋	糹 宏
綌	糹 谷
綍	糹 孛
綎	糹 廷
綏	糹 妥
綐	糹 兑
綑	糹 困
綒	糹 孚
經	糹 巠
綔	夸 系
綕	糹 志
綖	糹 延
綗	糹 LD
綘	糹 夆
継	糹 Z 米
続	糹 売
綛	糹 忍
綜	糹 宗
綝	糹 林
綞	糹 垂
綟	糹 戾
綠	糹 彔
綡	糹 京
綢	糹 周
綣	糹 卷
綤	邵 糸
綥	糹 畀
綧	糹 享
綨	糹 其
綩	糹 宛
綪	糹 青
綫	糹 戔
綬	糹 受
維	糹 隹
綯	糹 匋
綰	糹 官
綱	糹 LD
網	糹 LD
綳	糹 朋
綴	糹 叕
綵	糹 采
綶	糹 果
綷	糹 卒
綸	糹 侖
綹	糹 咎
綺	糹 奇
綻	糹 定
綼	糹 卑
綽	糹 卓
綾	糹 夌
綿	糹 帛
緀	糹 妻
緁	糹 疌
緂	糹 炎
緃	糹 从 止
緄	糹 昆
緅	糹 取
緆	糹 易
緇	糹 甾
緈	糹 幸
緉	糹 兩
緊	臤 糸
緋	糹 非
緌	糹 委
緍	糹 昏
緎	糹 或
総	糹 忩
緐	每 系
緑	糹 录
緒	糹 者
緓	糹 英
緔	糹 尚
緕	糹 斉
緖	糹 者
緗	糹 相
緘	糹 咸
緙	糹 革
線	糹 泉
緛	糹 耎
緜	帛 系
緝	糹 咠
緞	糹 段
緟	糹 重
締	糹 帝
緡	糹 昬
緢	糹 苗
緣	糹 彖
緤	糹 枼
緥	糹 保
緦	糹 思
緧	糹 酋
編	糹 扁
緩	糹 爰
緪	糹 恆
緫	糹 怱
緬	糹 面
緭	糹 胃
緮	糹 复
緯	糹 韋
緰	糹 俞
緱	糹 侯
緲	糹 眇
緳	广 絜
練	糹 柬
緵	糹 凶 八 夂
緶	糹 便
緷	糹 軍
緸	糹 垔
緹	糹 是
緺	糹 咼
緻	糹 致
緼	糹 昷
緽	糹 貞
緾	糹 厘
緿	糹 怠
縀	糹 叚
縁	糹 彐 GQ
縂	糹 总
縃	糹 胥
縄	糹 日 电	# 日 交
縅	糹 威
縆	糹 恒
縇	糹 宣
縈	𤇾 糸
縉	糹 晋
縊	糹 益
縋	糹 追
縌	糹 逆
縍	糹 旁
縎	糹 骨
縏	般 糸
縐	糹 芻
縑	糹 兼
縒	糹 差
縓	糹 原
縔	糹 桑
縕	糹 囚 皿
縖	糹 害
縗	糹 衰
縘	糹 奚
縙	糹 茸
縚	糹 舀
縛	糹 尃
縜	糹 員
縝	糹 真
縞	糹 高
縟	糹 辱
縡	糹 宰
縣	LC 小 系
縤	糹 素
縥	糹 秦
縦	糹 従
縧	糹 條
縨	糹 晃
縩	糹 祭
縪	糹 畢
縫	糹 逢
縬	糹 戚
縭	糹 离
縮	糹 宿
縯	糹 寅
縰	糹 徙
縱	糹 從
縲	糹 累
縳	糹 專
縴	糹 牽
縵	糹 曼
縶	執 糸
縷	糹 婁
縸	糹 莫
縹	糹 票
縺	糹 連
縼	糹 旋
總	糹 悤
績	糹 責
縿	糹 參
繀	糹 崔
繂	糹 率
繃	糹 崩
繅	糹 巢
繆	糹 翏
繈	糹 強
繉	糹 目 兆
繊	糹 𢦏 业
繋	軗 糸
繌	糹 囟 八 夂
繍	糹 粛
繎	糹 然
繏	糹 巽
繐	糹 惠
繑	糹 喬
繒	糹 曾
繓	糹 最
織	糹 戠
繕	糹 善
繖	糹 散
繗	糹 粦
繘	糹 矞
繙	糹 番
繚	糹 尞
繛	素 卓
繜	糹 尊
繝	糹 閒
繞	糹 堯
繟	糹 單
繠	惢 糸
繡	糹 肅
繢	糹 貴
繣	糹 畫
繤	艹 目 大 糸
繥	糹 喜
繦	糹 强
繧	糹 雲
繨	糹 達
繩	糹 黽
繪	糹 會
繫	車 凵 殳 糸
繬	糹 嗇
繭	艹 LD
繮	糹 畺
繯	糹 睘
繰	糹 喿
繱	糹 葱
繲	糹 解
繳	糹 敫
繴	辟 糸
繵	糹 亶
繶	糹 意
繷	糹 農
繸	糹 遂
繹	糹 睪
繺	糹 煞
繻	糹 需
繼	糹 Z 幺 幺 一 幺 幺
繽	糹 賓
繾	糹 遣
繿	糹 監
纀	糹 僕
纁	糹 熏
纃	糹 齊
纄	糹 蓬
纅	糹 樂
纆	糹 墨
纇	米 糸 頁
纈	糹 頡
纉	糹 賛
纊	糹 廣
纋	糹 憂
續	糹 賣
纍	畾 糸
纎	糹 韯
纏	糹 廛
纐	糹 頝
纑	糹 盧
纒	糹 厂 墨
纓	糹 嬰
纔	糹 毚
纕	糹 襄
纖	糹 韱
纗	糹 巂
纘	糹 贊
纙	糹 羅
纚	糹 麗
纜	糹 覽
纝	糹 纍
纞	糹 戀
绬	纟 英
缷	缶 卩
缹	缶 灬
缻	缶 瓦
缼	缶 欠
缽	缶 本
缾	缶 并
缿	缶 后
罀	缶 兆
罁	缶 LD
罃	𤇾 缶
罆	缶 貫
罇	缶 尊
罈	缶 覃
罉	缶 掌
罊	車 凵 殳 缶
罋	雍 缶
罌	賏 缶
罎	缶 曇
罏	缶 盧
罒	LK	AAA  
罓	冂 乂
罖	四 亽
罙	⺳ 木
罛	四 瓜
罜	四 主
罝	四 且
罞	四 矛
罠	四 民
罣	四 圭
罤	四 弟
罥	四 肙
罦	四 孚
罧	四 林
罫	四 卦
罬	四 叕
罭	四 或
罯	四 音
罰	四 言 刂
罳	四 思
罵	四 馬
罷	四 能
罸	四 討
罺	四 巢
罻	四 尉
罼	四 畢
罿	四 童
羀	LD 畱
羂	四 絹
羃	四 幕
羄	四 綽
羅	四 維
羆	四 熊
羇	四 革 奇
羈	四 革 馬
羉	四 龻
羋	卝 丨 BI	# 特殊
羍	大 羊
羏	羊 彡
羐	艹 土 久	# 上从艹
羒	羊 分
羗	羌 厶
羘	月 羊
羙	羊 火
羛	羊 弗
羜	羊 宁
羠	羊 夷
羢	羊 戎
羣	君 羊
羥	羊 巠
羦	羊 完
羨	羊 氵 欠
義	羊 我
羪	羊 良
羫	羊 空
羬	羊 咸
羭	羊 俞
羮	羔 一 夫	#** 特殊；单拆一
羳	羊 番
羴	羊 羊 羊
羵	羊 賁
羶	羊 亶
羷	羊 僉
羺	羊 需
羻	羊 慶
羾	羽 工
翄	羽 支
翆	羽 卆
翇	羽 犮
翉	本 羽
翋	羽 立
翍	羽 皮
翏	羽 人 彡
翐	羽 失
翑	羽 句
習	羽 白
翓	吉 羽
翖	合 羽
翗	多 羽
翜	羽 夾
翝	宏 羽
翞	羽 京
翢	周 羽
翣	羽 妾
翤	口 LD 羽
翧	宣 羽
翨	羽 是
翪	羽 凶 八 夂
翫	習 元
翬	羽 軍
翭	羽 侯
翲	票 羽
翴	羽 連
翵	羽 鳥
翶	皐 羽
翸	賁 羽
翹	堯 羽
翺	臯 羽
翽	歲 羽
翿	壽 羽
耈	老 句
耉	耂 丿 Z 口
耊	耂 至
耎	而 大
耓	耒 丁
耚	耒 皮
耛	耒 台
耝	耒 且
耞	耒 加
耟	耒 巨
耡	耒 助
耣	耒 侖
耫	耒 責
耬	耒 婁
耭	耒 幾
耮	耒 勞
耯	耒 蒦
耲	耒 褱
耴	耳 乚
耹	耳 今
耺	耳 云
耼	耳 冄
耾	耳 厷
聀	耳 戈
聁	耳 分
聄	耳 人 彡
聅	耳 矢
聇	耳 正
聈	耳 幼
聉	耳 出
聎	耳 兆
聏	耳 而
聐	耳 吉
聑	耳 耳
聓	巩 耳
聕	耳 告
聖	耳 口 王
聗	耳 夾
聙	耳 青
聛	耳 卑
聜	耳 空
聝	耳 或
聞	門 耳
聟	知 耳
聠	耳 并
聡	耳 忩
聢	耳 定
聣	耳 兒
聤	耳 亭
聥	耳 禹
聦	耳 怱
聧	耳 癸
聨	耳 幺 幺 廾
聫	耳 幺 幺 大
聬	耳 翁
聭	耳 鬼
聮	耳 幺 幺 灬
聯	耳 幺 幺 丱
聰	耳 悤
聲	殸 耳
聳	從 耳
聴	耳 十 四 心
聵	耳 貴
聶	耳 聑
職	耳 戠
聸	耳 詹
聹	耳 寧
聺	耳 察
聻	漸 耳
聼	乛 耳 十 四 一 心
聽	耳 王 十 四 一 心	# 特殊：左从王不从壬
聾	龍 耳
肁	户 聿
肂	歹 聿
肅	肀 ND
肈	户 戈 聿
肊	月 乙
肍	月 九
肎	冖 月
肏	入 肉
肐	月 乞
肑	月 勺
肒	月 丸
肔	月 也
肕	月 刃
肗	月 女
肙	口 月
肞	月 义
肣	月 今
肦	月 分
肧	月 不
肨	月 丰
肬	月 尤
肰	月 犬
肳	月 勿
肵	月 斤
肶	月 比
肹	月 兮
肻	卜 肎
胅	月 失
胇	月 弗
胉	月 白
胊	月 句
胋	月 占
胏	月 丿 Z 丨 丿
胐	月 出
胑	月 只
胒	月 尼
胓	月 平
胔	此 肉
胕	月 付
胘	月 玄
胟	月 母
胢	月 可
胦	月 央
胮	月 夅
胵	月 至
胷	匈 月
胹	月 而
胻	月 行
胾	𢦏 肉
胿	月 圭
脀	丞 月
脁	月 兆
脃	月 色
脄	月 灰
脅	劦 月
脇	月 劦
脈	月 ⺁ 氏
脋	刕 月
脌	月 年
脕	月 免
脗	月 勿 口
脙	月 求
脛	月 巠
脜	月 一 自
脝	月 亨
脠	月 延
脡	月 廷
脢	月 每
脣	辰 月
脤	月 辰
脥	月 夾
脦	月 忒
脧	月 夋
脨	月 束
脪	月 希
脫	月 兌
脭	月 呈
脮	月 妥
脰	月 豆
脳	月 VD 凶
脴	月 否
脵	月 吴
脷	月 利
脹	月 長
脺	月 卒
脻	月 疌
脼	月 兩
脽	月 隹
腀	月 侖
腁	月 幷
腂	月 果
腃	月 卷
腄	月 垂
腅	月 炎
腇	月 委
腉	月 兒
腍	月 念
腎	臤 月
腏	月 叕
腖	月 東
腗	月 畁
腛	月 屋
腜	月 某
腝	月 耎
腞	月 彖
腟	月 室
腡	月 咼
腢	月 禺
腣	月 帝
腤	月 音
腦	月 巛 囟
腪	月 軍
腫	月 重
腬	月 柔
腲	月 畏
腳	月 卻
腵	月 叚
腶	月 段
腷	月 畐
腸	月 昜
膁	月 兼
膃	月 囚 皿
膄	月 叟
膅	月 唐
膆	月 素
膇	月 追
膉	月 益
膋	𤇾 月
膌	月 脊
膍	月 囟 比
膎	月 奚
膐	旅 肉
膒	月 區
膓	月 𠂉 昜
膔	月 鹿
膕	月 國
膖	月 逢
膗	月 崔
膚	虍 胃
膞	月 專
膟	月 率
膠	月 翏
膡	月 眷
膢	月 婁
膤	月 雪
膥	末 成 肉
膧	月 童
膩	月 貳
膫	月 尞
膬	月 毳
膭	月 貴
膮	月 堯
膯	月 登
膰	月 番
膱	月 戠
膲	月 焦
膴	月 無
膵	月 萃
膶	月 閏
膷	月 鄉
膸	月 遀
膹	月 賁
膼	月 過
膽	月 詹
膾	月 會
膿	月 農
臄	月 豦
臅	月 蜀
臇	月 雋
臈	月 葛
臉	月 僉
臋	殿 肉
臍	月 齊
臎	月 翠
臏	月 賓
臐	月 熏
臒	月 蒦
臓	月 蔵
臔	月 賢
臕	月 麃
臖	興 月
臗	月 寬
臘	月 巤
臙	月 燕
臚	月 盧
臛	月 霍
臝	吂 月 果 凡
臞	月 瞿
臟	月 藏
臠	龻 肉
臡	難 肉
臢	月 贊
臤	臣 又
臥	臣 人
臦	X 丨 匚 丨 臣
臨	臣 𠂉 品
臩	臦 夰
臫	自 乚
臮	自 亻 人 人
臯	自 V 十
臰	自 死
臱	自 穴 方
臲	臬 危
臵	至 各
臶	至 存
臷	𢦏 至
臸	至 至
臹	至 成
臺	吉 冖 至
臽	⺈ 臼
臿	千 臼
舃	臼 一 Z 灬
與	臼 一 Z 丨 八
興	臼 同 八
舉	與 BI
舊	萑 臼
舋	臼 同 且
舎	人 土 口
舏	舌 丩
舑	舌 冉
舓	舌 易
舕	舌 炎
舖	舍 甫
舗	舎 甫
舘	舍 官
舙	舌 舌 舌
舚	舌 詹
舝	X 巛 冖 厶 MB
舤	舟 凡
舦	舟 太
舧	舟 丿 凡
舩	舟 公
舮	舟 户
舺	舟 甲
舼	舟 共
舽	舟 夅
舿	舟 夸
艀	舟 孚
艁	舟 告
艂	舟 夆
艃	舟 里
艆	舟 良
艈	舟 亠 厶 川
艊	舟 帛
艌	舟 念
艍	舟 居
艐	舟 凶 八 夂
艑	舟 扁
艒	舟 冒
艓	舟 枼
艔	舟 度
艕	舟 旁
艖	舟 差
艗	舟 益
艙	舟 倉
艛	舟 婁
艜	舟 帶
艝	舟 雪
艞	舟 筄
艠	舟 登
艡	舟 當
艢	舟 嗇
艣	舟 虜
艤	舟 義
艥	舟 戢
艦	舟 監
艧	舟 蒦
艩	舟 齊
艪	舟 魯
艫	舟 盧
艬	舟 毚
艭	舟 雙
艱	廿 口 夫 艮	# 口 交
艵	并 色
艶	豊 色
艷	豐 色
艸	屮 屮
艻	艹 力
艼	艹 丁
芀	艹 刀
芁	艹 几
芅	艹 弋
芆	艹 叉
芇	艹 巾
芉	艹 干
芌	艹 亏
芐	艹 下
芓	艹 子
芔	屮 艸
芕	艹 夕
芖	艹 大
芚	艹 屯
芛	艹 尹
芞	艹 气
芢	艹 仁
芧	艹 予
芲	艹 仑
芵	艹 夬
芶	艹 勾
芺	艹 夭
芻	勹 屮 勹 屮
芿	艹 仍
苀	艹 亢
苂	艹 火
苃	艹 友
苅	艹 刈
苆	艹 切
苐	艹 YZ
苖	艹 由
苙	艹 立
苚	艹 LD
苝	艹 北
苢	艹 Y
苨	艹 尼
苩	艹 白
苪	艹 丙
苬	艹 囚
苭	艹 幼
苮	艹 仙
苰	艹 弘
苲	艹 乍
苳	艹 冬
苵	艹 失
苶	艹 尒
苸	艹 乎
苺	艹 母
苼	艹 生
苽	艹 瓜
苿	艹 未
茊	艹 丘
茍	卝 句	# 非“苟”
茐	艹 匆
茒	艹 邜
茖	艹 各
茘	艹 刕
茙	艹 戎
茞	艹 臣
茟	艹 聿
茠	艹 休
茡	艹 字
茢	艹 列
茣	艹 吴
茤	艹 多
茥	艹 圭
茦	艹 朿
茩	艹 后
茪	艹 光
茮	艹 尗
茰	艹 日 乂	# 日 交
茲	艹 幺 幺	# 非“兹”
茷	艹 伐
茻	艸 艸
茾	艹 开
茿	艹 巩
荂	艹 夸
荅	艹 合
荈	艹 舛
荊	艹 刑
荋	艹 而
荌	艹 安
荍	艹 收
荎	艹 至
荕	艹 肋
荗	艹 戍
荘	艹 壮
荝	艹 则
荢	艹 宇
荰	艹 杜
荱	艹 尾
荲	艹 里
荳	艹 豆
荴	艹 扶
荵	艹 忍
荶	艹 吟
荹	艹 步
荺	艹 均
荾	艹 夋
荿	艹 成
莀	艹 辰
莁	艹 巫
莂	艹 别
莃	艹 希
莄	艹 更
莇	艹 助
莈	艹 没
莊	艹 壯
莋	艹 作
莌	艹 兑
莍	艹 求
莏	艹 抄
莐	艹 沈
莑	艹 夆
莔	艹 囧
莕	艹 杏
莖	艹 巠
莗	艹 車
莚	艹 延
莟	艹 含
莡	艹 足
莢	艹 夾
莣	艹 忘
莤	艹 酉
莥	艹 狃
莦	艹 肖
莧	艹 見
莬	艹 免
莭	艹 即
莮	艹 男
莯	艹 沐
莵	艹 丿 口 儿 丶	# 非“菟”
莻	艿 叱
莾	艹 奔
菃	艹 洰
菄	艹 東
菆	艹 取
菈	艹 拉
菋	艹 味
菎	艹 昆
菐	业 UC
菑	艹 甾
菒	艹 杲
菓	艹 果
菕	艹 侖
菗	艹 抽
菙	艹 垂
菚	艹 戔
菛	艹 門
菞	艹 禾 勹 丿
菢	艹 抱
菣	艹 臤
菤	艹 卷
菦	艹 近
菧	艹 底
菨	艹 妾
菫	艹 一 口 CI
菬	艹 沼
菭	艹 治
菮	艹 庚
華	艹 一 艹 BI	# 艹 交
菳	艹 金
菴	艹 奄
菵	艹 LD
菶	艹 奉
菷	艹 帚
菺	艹 肩
菻	艹 林
菾	艹 忝
菿	艹 到
萀	艹 虎
萂	艹 和
萅	艹 旾
萇	艹 長
萈	艹 見 丶
萉	艹 肥
萊	艹 來
萐	艹 疌
萒	艹 兖
萓	艹 宜
萔	艹 招
萕	艹 斉
萖	艹 兒
萗	艹 宗
萙	艹 枕
萛	苜 廾
萞	艹 LD 比
萟	艹 秇
萠	艹 朋
萡	艹 泊
萢	艹 泡
萪	艹 科
萫	艹 香
萬	艹 禺
萭	艹 禹
萮	艹 俞
萯	艹 負
萰	艹 柬
萲	艹 爰
萴	艹 則
萵	艹 咼
萶	艹 春
萷	艹 削
萺	艹 冒
萻	艹 音
萾	艹 盈
萿	艹 活
葀	艹 括
葁	艹 姜
葂	艹 勉
葃	艹 昨
葄	艹 胙
葅	艹 俎
葇	艹 柔
葈	艹 枲
葉	艹 枼
葊	艹 弇
葋	艹 朐
葌	艹 姦
葍	艹 畐
葏	艹 津
葐	艹 盆
葒	艹 紅
葓	艹 洪
葔	艹 侯
葕	艹 衍
葘	艹 巛 一 田
葝	艹 勁
葞	艹 弭
葟	艹 皇
葠	艹 侵
葢	艹 盇
葤	艹 紂
葥	艹 前
葦	艹 韋
葧	艹 勃
葨	艹 畏
葪	艹 角 刂
葮	艹 段
葯	艹 約
葲	艹 泉
葷	艹 軍
葹	艹 施
葻	艹 風
葼	艹 凶 八 夂
葽	艹 要
葾	艹 怨
葿	艹 眉
蒀	艹 昷
蒁	艹 述
蒃	艹 彖
蒅	艹 染
蒆	艹 巩 女
蒊	花 叱
蒍	艹 為
蒏	艹 冖 酉
蒑	艹 殷
蒒	艹 師
蒓	艹 純
蒔	艹 時
蒕	艹 囚 皿
蒖	艹 真
蒘	艹 挐
蒚	艹 鬲
蒛	艹 缺
蒝	艹 原
蒞	艹 涖
蒠	艹 息
蒢	艹 除
蒣	艹 徐
蒤	艹 涂
蒥	艹 留
蒦	艹 隻
蒧	茂 占
蒩	艹 租
蒪	艹 尃
蒫	艹 差
蒬	艹 冤
蒭	艹 芻
蒮	艹 隺
蒰	艹 般
蒳	艹 納
蒵	艹 奚
蒶	艹 紛
蒷	艹 員
蒼	艹 倉
蒾	艹 迷
蓀	艹 孫
蓃	艹 叟
蓅	艹 流
蓆	艹 席
蓈	艹 郎
蓋	艹 盍
蓌	艹 夎
蓎	艹 唐
蓒	艹 軒
蓔	艹 羔
蓕	艹 桂
蓗	艹 徒
蓘	艹 衮
蓙	艹 座
蓚	艹 修
蓛	艹 敇
蓜	艹 配
蓞	艹 舀
蓡	艹 浸
蓤	艹 凌
蓧	艹 條
蓨	艹 脩
蓩	艹 務
蓪	艹 通
蓫	艹 逐
蓭	艹 庵
蓮	艹 連
蓯	艹 從
蓱	艹 洴
蓲	艹 區
蓳	艹 堇
蓴	艹 專
蓵	艹 捷
蓶	艹 唯
蓷	艹 推
蓸	艹 曹
蓹	艹 御
蓺	艹 埶
蓻	艹 執
蓽	艹 畢
蓾	艹 鹵
蔁	艹 章
蔂	艹 累
蔄	艹 問
蔅	艹 門 女
蔆	艹 淩
蔇	艹 既
蔉	艹 袞
蔋	艹 淑
蔍	艹 鹿
蔎	艹 設
蔏	艹 商
蔐	艹 啇
蔒	艹 焄
蔔	艹 匐
蔕	艹 帶
蔖	艹 虘
蔘	艹 參
蔙	艹 旋
蔛	艹 斛
蔜	艹 敖
蔝	艹 眯
蔞	艹 婁
蔠	艹 終
蔢	艹 婆
蔣	艹 將
蔤	艹 密
蔥	艹 悤
蔦	艹 鳥
蔧	艹 彗
蔨	艹 圈
蔩	艹 寅
蔪	艹 斬
蔭	艹 陰
蔮	艹 國
蔯	艹 陳
蔰	艹 扈
蔱	艹 殺
蔲	艹 宀 元 攵	# 非“蔻”
蔳	艹 清
蔴	艹 麻
蔵	茂 臣
蔶	艹 責
蔾	艹 棃
蔿	艹 爲
蕀	艹 棘
蕁	艹 尋
蕂	艹 勝
蕄	艹 悶
蕅	艹 湡
蕆	茂 貝
蕇	艹 單
蕋	艹 歮
蕌	艹 晶
蕍	艹 渝
蕎	艹 喬
蕏	艹 猪
蕐	艹 一 仌 仌 BI
蕑	艹 閒
蕒	艹 買
蕓	艹 雲
蕔	艹 報
蕕	艹 猶
蕘	艹 堯
蕚	艹 品 亏
蕛	艹 稊
蕜	艹 悲
蕝	艹 絶
蕟	艹 發
蕠	艹 絮
蕡	艹 賁
蕢	艹 貴
蕣	艹 舜
蕥	艹 雅
蕦	艹 須
蕧	艹 復
蕩	艹 湯
蕪	艹 無
蕫	艹 童
蕬	艹 絲
蕭	艹 肅
蕮	艹 舄
蕯	艹 隆
蕱	艹 稍
蕳	艹 間
蕵	艹 飧
蕶	艹 零
蕷	艹 預
蕸	艹 遐
蕼	艹 肆
蕽	艹 農
蕿	艹 煖
薀	艹 溫
薂	艹 敫
薃	艹 滈
薆	艹 愛
薈	艹 會
薉	艹 歲
薊	艹 魝
薋	艹 資
薌	艹 鄉
薍	艹 亂
薎	艹 四 冖 伐
薐	艹 稜
薑	艹 畺
薒	艹 粲
薓	艹 氵 帚 又
薔	艹 嗇
薕	艹 廉
薖	艹 過
薗	艹 園
薘	艹 達
薙	艹 雉
薚	艹 歹 昜
薝	艹 詹
薞	艹 飱
薟	艹 僉
薠	艹 煩
薡	艹 鼎
薣	艹 鼓
薥	艹 蜀
薦	艹 廌
薧	艹 亠 口 冖 死
薩	艹 隡
薫	艹 重 灬	# 非“薰”
薬	艹 楽
薭	艹 稗
薱	艹 對
薲	艹 賓
薴	艹 寧
薵	艹 壽
薶	艹 貍
薺	艹 齊
薻	艹 漅
薼	艹 塵
薽	艹 甄
薾	艹 爾
藀	艹 熒
藂	艹 聚
藃	艹 歊
藄	艹 綦
藅	艹 罰
藆	艹 搴
藇	艹 與
藈	艹 睽
藊	艹 稨
藋	艹 翟
藌	艹 蜜
藍	艹 監
藎	艹 盡
藑	艹 夐
藒	艹 禾 曷
藔	艹 寮
藖	艹 賢
藗	艹 遬
藘	艹 慮
藙	艹 毅
藚	艹 賣
藛	艹 寫
藝	蓺 云
藞	艹 磊
藡	艹 適
藢	艹 徵
藣	艹 罷
藥	艹 樂
藧	艹 緩
藪	艹 數
藫	艹 潭
藬	艹 隤
藭	艹 窮
藮	艹 樵
藯	艹 慰
藰	艹 劉
藱	艹 瘣
藲	艹 樞
藳	艹 稾
藴	艹 緼
藵	葆 衣
藶	艹 歷
藷	艹 諸
藸	艹 豬
藹	艹 謁
藺	艹 閵
藼	艹 憲
藽	艹 親
藾	艹 賴
蘀	艹 擇
蘁	艹 噩
蘂	艹 橤
蘃	艹 歮 木
蘄	艹 單 斤
蘆	艹 盧
蘇	艹 穌
蘈	艹 頽
蘉	艹 四 冖 侵
蘊	艹 縕
蘋	艹 頻
蘌	艹 禦
蘍	艹 勳
蘎	艹 雨 肥
蘏	艹 頴
蘐	艹 諼
蘒	艹 穐
蘓	艹 禾 魚
蘔	艹 穎
蘕	艹 縫
蘗	艹 檗
蘙	艹 翳
蘚	艹 鮮
蘛	艹 甚 育
蘜	艹 鞠
蘝	艹 歛
蘞	艹 斂
蘟	艹 隱
蘠	艹 牆
蘡	艹 嬰
蘢	艹 龍
蘣	艹 黈
蘤	艹 白 爲
蘥	艹 龠
蘦	艹 霝
蘨	艹 繇
蘪	艹 麋
蘫	艹 濫
蘬	艹 歸
蘭	艹 闌
蘮	艹 四 厂 炎 刂
蘯	艹 盪
蘰	艹 縵
蘱	艹 類
蘲	艹 壘
蘳	艹 黊
蘴	艹 豐
蘵	艹 職
蘶	艹 魏
蘷	艹 一 止 白 巳 八 夂	# 非“虁”
蘹	艹 懷
蘺	艹 離
蘻	艹 繫
蘽	艹 櫐
蘾	艹 壞
蘿	艹 羅
虀	艹 韲
虁	艹 夒	# 从夒不从夔
虂	艹 露
虃	艹 瀸
虄	艹 虫 夂 産
虅	艹 騰
虆	艹 纍
虇	艹 弓 雚
虈	艹 嚻
虉	艹 鷊
虊	艹 欒
虋	艹 釁
虌	艹 鼈
處	虍 処
虖	虍 乎
虗	虍 丘
虘	虍 且
虙	虍 必
虛	虍 业
虜	虍 男
虝	虎 勿
號	号 虎
虠	交 虎
虡	虚 八
虣	武 虎
虥	虎 戔
虦	戔 虎
虧	雐 亏
虨	虍 林 彡
虩	小 日 小 虎
虪	虎 儵
虭	虫 刀
虯	虫 丩
虰	虫 丁
虲	虫 卜
虳	虫 勺
虴	虫 乇
虵	虫 也
虶	虫 于
蚃	乡 虫
蚅	虫 厄
蚇	虫 尺
蚈	虫 开
蚉	文 虫
蚎	虫 日
蚏	虫 月
蚐	虫 匀
蚑	虫 支
蚒	虫 丹
蚔	虫 氏
蚖	虫 元
蚗	虫 夬
蚘	虫 尤
蚙	虫 今
蚚	虫 斤
蚛	虫 中
蚞	虫 木
蚟	虫 王
蚠	分 虫
蚡	虫 分
蚢	虫 亢
蚥	虫 父
蚦	虫 冄
蚫	虫 包
蚭	虫 尼
蚮	虫 代
蚳	虫 氐
蚷	虫 巨
蚸	虫 斥
蚹	虫 付
蚻	札 虫
蚼	虫 句
蚽	虫 丕
蚾	虫 皮
蚿	虫 玄
蛁	虫 召
蛂	虫 犮
蛅	虫 占
蛈	虫 失
蛌	虫 瓜
蛍	VD 冖 虫
蛒	虫 各
蛓	𢦏 虫
蛕	虫 有
蛖	虫 尨
蛗	丿 Y 虫
蛚	虫 列
蛜	虫 伊
蛝	虫 艮
蛠	虫 劦
蛡	虫 羽
蛢	虫 并
蛣	虫 吉
蛥	虫 多
蛦	虫 夷
蛧	虫 LD
蛨	虫 百
蛪	丰 刀 虫
蛫	虫 危
蛬	共 虫
蛯	虫 老
蛵	虫 巠
蛶	虫 寽
蛷	虫 求
蛺	虫 夾
蛻	虫 兌
蛼	虫 車
蛽	虫 貝
蛿	虫 含
蜁	虫 𠂉 疋
蜄	虫 辰
蜅	虫 甫
蜆	虫 見
蜋	虫 良
蜌	虫 坒
蜏	虫 秀
蜑	延 虫
蜔	虫 甸
蜖	虫 囬
蜙	虫 松
蜛	虫 居
蜝	其 虫
蜟	虫 育
蜠	虫 囷
蜤	析 虫
蜦	虫 侖
蜧	虫 戾
蜨	虫 疌
蜪	虫 匋
蜫	虫 昆
蜬	虫 函
蜭	虫 臽
蜯	虫 奉
蜰	肥 虫
蜲	虫 委
蜳	虫 享
蜵	虫 ND
蜶	虫 卒
蜸	臤 虫
蜹	虫 芮
蜺	虫 兒
蜼	虫 隹
蜽	虫 兩
蝀	虫 東
蝁	亞 虫
蝂	虫 版
蝃	虫 叕
蝄	虫 LD
蝅	天 天 虫
蝆	虫 芈
蝊	虫 定
蝋	虫 鼡
蝍	虫 即
蝏	虫 亭
蝐	虫 冒
蝑	虫 胥
蝒	虫 面
蝔	虫 皆
蝕	食 虫
蝖	虫 宣
蝚	虫 柔
蝛	虫 威
蝜	虫 負
蝝	虫 彖
蝞	虫 眉
蝟	虫 胃
蝡	虫 耎
蝢	虫 頁
蝦	虫 叚
蝧	虫 英
蝨	卂 虫 虫
蝩	虫 重
蝪	虫 昜
蝫	虫 者
蝬	虫 凶 八 夂
蝭	虫 是
蝯	虫 爰
蝱	亡 虫 虫
蝳	虫 毒
蝵	秋 虫
蝷	虫 广 屰
蝸	虫 咼
蝹	虫 昷
蝺	虫 禹
蝿	虫 日 电	# 日 交
螀	将 虫
螁	虫 退
螄	虫 師
螆	虫 兹
螇	虫 奚
螉	虫 翁
螊	虫 兼
螌	般 虫
螎	虫 鬲
螏	虫 疾
螐	虫 烏
螑	虫 臭
螒	龺 人 虫
螔	虫 虒
螕	虫 囟 比
螖	虫 骨
螘	虫 豈
螙	木 虫 虫
螚	能 虫
螛	虫 害
螜	士 冖 一 殳 虫
螝	虫 鬼
螞	虫 馬
螡	文 虫 虫
螢	𤇾 虫
螤	蚉 日 人	# 日 交
螥	虫 倉
螦	虫 素
螧	虫 耆
螩	虫 條
螪	虫 商
螮	虫 帶
螰	虫 鹿
螲	虫 窒
螴	陳 虫
螶	巨 虫 虫
螷	庳 虫
螸	欲 虫
螹	虫 斬
螻	虫 婁
螼	虫 堇
螾	虫 寅
螿	將 虫
蟁	民 虫 虫
蟂	虫 梟
蟃	虫 曼
蟄	執 虫
蟅	虫 庶
蟇	莫 虫
蟈	虫 國
蟉	虫 翏
蟌	虫 悤
蟍	虫 梨
蟎	虫 廿 冂 丨 入 入
蟐	虫 常
蟔	虫 黑
蟕	虫 觜
蟖	虫 斯
蟗	一 中 冖 出 虫
蟘	虫 貸
蟙	虫 戠
蟚	彭 虫
蟜	虫 喬
蟝	虫 渠
蟞	敝 虫
蟟	虫 尞
蟡	虫 爲
蟢	虫 喜
蟣	虫 幾
蟤	虫 巽
蟦	虫 賁
蟧	虫 勞
蟨	厥 虫
蟩	虫 厥
蟬	虫 單
蟭	虫 焦
蟯	虫 堯
蟰	虫 肅
蟱	虫 無
蟲	I
蟳	虫 尋
蟴	斯 虫
蟵	虫 厨
蟶	虫 聖
蟷	虫 當
蟸	豕 虫 虫
蟺	虫 亶
蟻	虫 義
蟼	敬 虫
蟽	虫 達
蟿	車 凵 殳 虫
蠀	虫 資
蠁	鄉 虫
蠂	虫 葉
蠄	虫 禽
蠅	虫 黽
蠆	萬 虫
蠇	虫 萬
蠈	賊 虫
蠉	虫 睘
蠌	虫 睪
蠍	虫 歇
蠎	虫 莾
蠏	虫 解
蠐	虫 齊
蠑	虫 榮
蠒	爾 虫
蠔	虫 豪
蠗	虫 翟
蠘	虫 截
蠙	虫 賓
蠚	若 虫 虫
蠜	樊 虫
蠝	虫 畾
蠞	節 虫
蠟	虫 巤
蠠	面 虫 虫
蠣	虫 厲
蠤	酋 虫 虫
蠥	辥 虫
蠦	虫 盧
蠧	士 冖 石 虫 虫
蠨	虫 蕭
蠩	虫 諸
蠪	龍 虫
蠫	豸 刂 虫 虫
蠬	虫 龍
蠭	逢 虫 虫
蠮	虫 翳
蠯	庳 虫 虫
蠰	虫 襄
蠱	蟲 皿
蠳	虫 嬰
蠴	虫 薯
蠵	虫 巂
蠶	朁 虫 虫
蠷	虫 瞿
蠸	虫 雚
蠺	天 天 日 虫 虫
蠻	龻 虫
蠽	雀 戈 虫 虫
蠾	虫 屬
蠿	幺 幺 一 幺 幺 一 丨 虫 虫	# 特殊
衁	亡 血
衂	血 刃
衆	血 GQ
衇	血 ⺁ 氏
衈	血 耳
衉	血 各
衊	血 蔑
衋	聿 百 百 血
衏	行 元
衐	行 巨
衑	行 令
術	行 术
衕	行 同
衖	行 共
衘	行 𠂉 一 止
衚	行 胡
衛	行 韋
衜	行 首
衝	行 重
衞	行 X 口 帀
衟	行 巛 一 自
衦	衤 干
衧	衤 于
衪	衤 也
衭	衤 夫
衯	衤 分
衱	衤 及
衳	衤 公
衴	衤 冘
衵	衤 日
衶	衤 中
衸	衤 介
衹	衤 氏
衺	亠 牙 氏
衻	衤 冄
衼	衤 支
袀	衤 匀
袃	切 衣
袇	衤 丹
袉	衤 它
袊	衤 令
袌	亠 包 RH
袎	衤 幼
袏	衤 左
袐	衤 必
袑	衤 召
袓	衤 且
袔	衤 可
袕	衤 穴
袘	衤 𠂉 也
袙	衤 白
袚	衤 犮
袛	衤 氐
袝	衤 付
袞	六 口 氏
袟	衤 失
袠	亠 失 氏
袡	衤 冉
袣	衤 世
袥	衤 石
袦	衤 出
袧	衤 句
袨	衤 玄
袩	衤 占
袬	亠 台 氏
袮	衤 尓
袰	母 衣
袲	亠 多 氏
袳	衤 多
袴	衤 夸
袵	衤 任
袶	衤 夅
袸	衤 存
袹	衤 百
袺	衤 吉
袻	衤 而
袽	衤 如
袾	衤 朱
袿	衤 圭
裀	衤 因
裃	衤 卜 二 卜
裄	衤 行
裇	衤 血
裊	鳥 衣
裋	衤 豆
裌	衤 夾
裍	衤 困
裏	亠 里 氏
裐	衤 肙
裑	衤 身
裓	衤 戒
裖	衤 辰
裗	衤 亠 厶 川
裚	折 衣
補	衤 甫
裝	壯 衣
裞	衤 兑
裠	君 衣
裡	衤 里
裦	亠 RH 一 矛 氏
裧	衤 炎
裩	衤 昆
裪	衤 匋
裫	衤 ND
裬	衤 夌
裭	衤 虎
裮	衤 昌
裯	衤 周
裲	衤 兩
裵	亠 非 氏
裶	衤 非
裷	衤 卷
裺	衤 奄
裻	叔 衣
製	制 衣
裿	衤 奇
褀	衤 其
褁	果 氏
褃	衤 肯
褄	衤 妻
褅	衤 帝
褆	衤 是
複	衤 复
褈	衤 重
褉	衤 契
褋	衤 枼
褌	衤 軍
褍	衤 耑
褎	亠 RH 一 禾 氏
褏	亠 RH 一 由 氏
褑	衤 爰
褔	衤 畐
褖	衤 彖
褗	衤 匽
褘	衤 韋
褜	胞 衣
褝	衤 单
褞	衤 昷
褠	衤 冓
褢	亠 鬼 氏
褣	衤 容
褤	衤 袁
褦	衤 能
褧	耿 衣
褨	衤 差
褩	般 衣
褬	衤 桑
褭	亠 馬 氏
褮	𤇾 衣
褱	亠 四 水 氏
褲	衤 庫
褳	衤 連
褵	衤 离
褷	衤 徙
褸	衤 婁
褹	衤 埶
褺	執 衣
褻	亠 埶 氏
褼	衤 西 大 巳
褽	尉 衣
褾	衤 票
褿	衤 曹
襀	衤 責
襂	衤 參
襃	亠 RH 一 呆 氏
襅	衤 畢
襆	衤 菐
襇	衤 間
襈	衤 巽
襉	衤 閒
襊	衤 最
襋	衤 棘
襌	衤 單
襍	衤 集
襎	衤 番
襏	衤 發
襐	衤 象
襑	衤 尋
襒	衤 敝
襓	衤 堯
襔	衤 廿 冂 丨 入 入
襖	衤 奥
襗	衤 睪
襘	衤 會
襙	衤 喿
襛	衤 農
襝	衤 僉
襠	衤 當
襡	衤 蜀
襢	衤 亶
襣	衤 鼻
襤	衤 監
襥	衤 僕
襧	衤 爾
襨	衤 對
襩	衤 賣
襪	衤 蔑
襬	衤 罷
襭	衤 頡
襮	衤 暴
襯	衤 親
襰	衤 賴
襱	衤 龍
襲	龍 衣
襳	衤 韱
襴	衤 闌
襵	衤 聶
襶	衤 戴
襷	衤 擧
襸	衤 贊
襹	衤 麗
襺	衤 繭
襼	衤 藝
襽	衤 蘭
襾	FJ	AAA
覀	FJ	AAA
覂	西 乏
覄	西 伏
覅	要 勿
覇	西 革 月
覈	西 敫
覉	西 革 奇
覊	西 革 馬
觍	典 见
見	LR
覌	又 見
覍	小 見
覎	見 子
規	夫 見
覐	見 爻
覑	片 見
覒	毛 見
覓	爪 見
覔	不 見
覕	必 見
視	礻 見
覗	司 見
覘	占 見
覙	尔 見	# 从尔不从尓
覚	VD 冖 見
覛	⺁ 氏 見
覜	兆 見
覝	干 火 見
覞	見 見
覟	志 見
覠	君 見
覡	巫 見
覢	炎 見
覣	委 見
覤	虎 見
覥	典 見
覦	俞 見
覧	臣 M 見
覨	咢 見
覩	者 見
親	亲 見
覫	旁 見
覬	豈 見
覭	冥 見
覮	𤇾 見
覯	冓 見
覰	虘 見
覱	斬 見
覲	堇 見
観	𠂉 一 隹 見
覴	登 見
覵	閒 見
覶	爪 龴 LD 見
覷	虚 見
覸	間 見
覹	見 微
覺	臼 爻 見
覻	虍 豆 見
覼	爾 見
覽	臣 M 四 見
覾	審 見
覿	賣 見
觀	雚 見
觓	角 丩
觔	角 力
觕	牛 角
觗	角 氏
觘	角 少
觙	角 及
觛	角 旦
觝	角 氐
觠	龹 角
觡	角 各
觢	丰 刀 角
觤	角 危
觧	角 羊
觨	角 汞
觩	角 求
觪	角 辛
觬	角 兒
觮	角 录
觰	角 者
觲	角 羊 牛
觴	角 𠂉 昜
觵	角 黄
觶	角 單
觷	臼 爻 角
觸	角 蜀
觹	角 雋
觺	疑 角
觻	角 樂
觼	角 夐
觽	角 嶲
觾	角 燕
訁	S	AAA
訂	言 丁
訃	言 卜
訅	言 九
訆	言 丩
計	言 十
訉	言 凡
訊	言 卂
訋	言 勺
訌	言 工
訍	言 叉
討	言 寸
訏	言 于
訐	言 干
訑	言 也
訒	言 刃
訓	言 川
訔	山 言
訕	言 山
訖	言 乞
託	言 乇
記	言 己
訙	言 丸
訛	言 化
訜	言 分
訝	言 牙
訞	言 夭
訟	言 公
訠	言 引
訡	言 今
訢	言 斤
訣	言 夬
訤	言 爻
訥	言 内
訦	言 冘
訧	言 尤
訨	言 止
訩	言 凶
訪	言 方
訫	言 心
訬	言 少
設	言 殳
訮	言 开
訯	言 及
訰	言 屯
許	言 午
訲	言 中
訳	言 尺
訴	言 斥
訵	言 四
訶	言 可
訷	言 申
訸	言 禾
訹	言 术
診	言 人 彡
註	言 主
証	言 正
訽	言 句
訿	言 此
詀	言 占
詁	言 古
詂	言 付
詃	言 玄
詄	言 失
詅	言 令
詆	言 氐
詇	言 央
詉	言 奴
詊	言 半
詋	言 兄
詌	言 甘
詍	言 世
詎	言 巨
詏	言 幼
詐	言 乍
詑	言 它
詒	言 台
詓	言 去
詔	言 召
評	言 平
詖	言 皮
詗	言 LD
詘	言 出
詙	言 犮
詚	言 旦
詛	言 且
詜	言 屮 又
詝	言 宁
詞	言 司
詠	言 永
詡	言 羽
詢	言 旬
詣	言 旨
詤	言 Z 人 川	# 特殊
詥	言 合
試	言 式
詧	RS 言
詨	言 交
詩	言 寺
詪	言 艮
詫	言 宅
詬	言 后
詭	言 危
詮	言 全
詯	言 自
詰	言 吉
話	言 舌
該	言 亥
詳	言 羊
詴	言 有
詵	言 先
詶	言 州
詷	言 同
詸	言 米
詺	言 名
詻	言 各
詼	言 灰
詽	言 幵
詾	言 匈
詿	言 圭
誀	言 耳
誁	言 并
誂	言 兆
誃	言 多
誄	言 耒
誅	言 朱
誆	言 匡
誇	言 夸
誈	言 至
誋	言 忌
誌	言 志
認	言 忍
誎	言 束
誏	言 良
誐	言 我
誑	言 狂
誒	言 矣
誔	言 廷
誕	言 延
誖	言 孛
誗	言 利
誘	言 秀
誙	言 巠
誚	言 肖
誛	言 彐 冖 又
誜	言 夋
誝	言 含
語	言 吾
誟	言 孝
誠	言 成
誡	言 戒
誢	言 見
誣	言 巫
誤	言 吴
誥	言 告
誦	言 甬
誧	言 甫
誨	言 每
誩	言 言
說	言 兌
誫	言 辰
説	言 兑
読	言 売
誮	言 花
誯	言 昌
誰	言 隹
誱	言 疌
課	言 果
誳	言 屈
誴	言 宗
誵	言 肴
誶	言 卒
誷	言 LD
誸	言 弦
誹	言 非
誺	言 來
誻	言 沓
誼	言 宜
誽	言 兒
誾	門 言
調	言 周
諀	言 卑
諁	言 叕
諂	言 臽
諃	言 林
諄	言 享
諅	其 言
諆	言 其
談	言 炎
諈	言 垂
諉	言 委
諊	言 匊
請	言 青
諌	言 東
諍	言 争
諎	言 昔
諏	言 取
諐	侃 言
諑	言 豖
諒	言 京
諓	言 戔
諔	言 叔
諕	言 虎
論	言 侖
諗	言 念
諘	言 表
諙	言 昏
諚	言 定
諛	言 臾
諜	言 枼
諝	言 胥
諞	言 扁
諟	言 是
諠	言 宣
諡	言 兮 皿
諢	言 軍
諣	言 咼
諤	言 咢
諥	言 重
諦	言 帝
諧	言 皆
諨	言 畐
諩	言 並
諪	言 亭
諫	言 柬
諬	禾 尤 言
諭	言 俞
諮	言 咨
諯	言 耑
諰	言 思
諱	言 韋
諲	言 垔
諳	言 音
諴	言 咸
諵	言 南
諶	言 甚
諷	言 風
諸	言 者
諹	言 昜
諺	言 彦
諻	言 皇
諼	言 爰
諽	言 革
諾	言 若
諿	言 咠
謀	言 某
謁	言 曷
謂	言 胃
謃	言 星
謄	月 誊
謅	言 芻
謆	言 扇
謈	日 共 言
謉	言 鬼
謊	言 荒
謋	言 桀
謌	言 哥
謍	𤇾 言
謎	言 迷
謏	言 叟
謐	言 必 皿
謑	言 奚
謒	言 倉
謓	言 真
謔	言 虐
謕	言 虒
謖	言 畟
謗	言 旁
謘	言 屖
謙	言 兼
謚	言 益
講	言 冓
謜	言 原
謝	言 射
謞	言 高
謟	言 舀
謠	言 RS 缶
謡	言 爪 缶
謢	言 隻
謣	言 雩
謤	言 票
謥	言 悤
謧	言 离
謨	言 莫
謩	莫 言
謪	言 商
謫	言 啇
謬	言 翏
謭	言 剪
謮	言 責
謯	言 虘
謰	言 連
謱	言 婁
謲	言 參
謳	言 區
謴	言 貫
謵	言 習
謶	言 庶
謷	敖 言
謸	言 敖
謹	言 堇
謺	執 言
謻	言 移
謼	言 虖
謽	强 言
謾	言 曼
謿	言 朝
譀	言 敢
譁	言 華
譂	言 單
譃	言 虚
譄	言 曾
譅	言 歰
譆	言 喜
譇	言 奢
譈	言 敦
證	言 登
譊	言 堯
譋	言 閒
譌	言 爲
譍	广 亻 隹 言
譎	言 矞
譏	言 幾
譐	言 尊
譑	言 喬
譒	言 番
譓	言 惠
譔	言 巽
譕	言 無
譖	言 朁
譗	言 答
識	言 戠
譙	言 焦
譚	言 覃
譛	言 替
譜	言 普
譝	言 黽
譞	言 睘
譟	言 喿
譠	言 亶
譡	言 當
譢	言 遂
譣	言 僉
譤	言 敫
譥	敫 言
譧	言 廉
譨	言 農
譩	言 意
譪	言 葛
譫	言 詹
譭	言 毁
譮	言 會
譯	言 睪
議	言 義
譱	羊 言 言
譲	言 六 甘 氏
譳	言 需
譴	言 遣
譵	言 對
譶	言 誩
護	言 蒦
譸	言 壽
譹	言 豪
譺	言 疑
譻	賏 言
譼	臣 M 四 言
譽	與 言
譾	言 翦
譿	言 慧
讀	言 賣
讁	言 適
讂	言 夐
讃	言 賛
讄	言 畾
讅	言 審
讆	衛 言
讇	言 閻
讈	言 歷
讉	言 遺
變	龻 攵
讋	龍 言
讌	言 燕
讍	言 噩
讎	隹 言 隹
讏	衞 言
讐	雔 言
讑	言 龠
讒	言 毚
讓	言 襄
讔	言 隱
讕	言 闌
讖	言 韱
讗	言 巂
讘	言 聶
讙	言 雚
讚	言 贊
讛	言 藝
讜	言 黨
讝	言 嚴
讞	言 獻
讟	讀 言
讬	讠 乇
诪	讠 寿
谉	讠 审
谸	丿 𠂇 谷
谹	谷 厷
谺	谷 牙
谻	谷 丮
谽	谷 含
谾	谷 空
豀	谷 奚
豂	谷 翏
豃	谷 敢
豄	谷 賣
豅	谷 龍
豈	山 豆
豊	曲 豆
豋	RS 豆
豍	豆 卑
豎	臤 豆
豏	豆 兼
豐	CI
豑	豊 弟
豒	豐 弟
豓	豐 盇
豔	豐 盍
豖	豕 丶
豗	兀 豕
豘	豕 屯
豙	立 GQ
豛	豕 殳
豜	豕 开
豝	豕 巴
豞	豕 句
豟	豕 戹
豠	豕 且
豣	豕 幵
豤	豕 艮
豥	豕 亥
豦	虍 豕
豧	豕 甫
豩	豕 豕
豬	豕 者
豭	豕 叚
豯	豕 奚
豰	士 冖 一 豕 殳
豱	豕 昷
豲	豕 原
豴	豕 啇
豵	豕 從
豶	豕 賁
豷	豕 壹
豻	豸 干
豼	豸 比
豽	豸 内
豾	豸 丕
豿	豸 句
貀	豸 出
貁	豸 穴
貃	豸 白
貄	豸 聿
貇	豸 艮
貈	豸 舟
貋	豸 旱
貍	豸 里
貎	豸 兒
貏	豸 卑
貐	豸 俞
貑	豸 叚
貒	豸 耑
貓	豸 苗
貕	豸 奚
貖	豸 益
貗	豸 婁
貙	豸 區
貚	豸 單
貛	豸 雚
貜	豸 矍
貝	LO
貞	卜 貝
貟	厶 貝
負	⺈ 貝
財	貝 才
貢	工 貝
貣	弋 貝
貤	貝 也
貥	貝 亢
貦	貝 元
貧	分 貝
貨	化 貝
販	貝 反
貪	今 貝
貫	毌 貝
責	丰 貝
貭	⺁ 十 貝
貮	一 弋 貝
貯	貝 宁
貰	世 貝
貱	貝 皮
貲	此 貝
貳	弋 二 貝
貴	中 一 貝
貵	厶 大 貝
貶	貝 乏
買	四 貝
貸	代 貝
貹	貝 生
貺	貝 兄
費	弗 貝
貼	貝 占
貽	貝 台
貾	貝 氐
貿	RH 丶 刀 貝
賀	加 貝
賁	十 艹 貝
賂	貝 各
賃	任 貝
賄	貝 有
賅	貝 亥
賆	貝 并
資	次 貝
賈	西 貝
賉	貝 血
賊	貝 戎
賋	貝 交
賌	亥 貝
賍	貝 庄
賎	貝 HM
賏	貝 貝
賐	貝 夋
賑	貝 辰
賒	貝 佘
賓	宀 一 小 貝
賔	宀 XM 貝
賕	貝 求
賖	貝 余
賗	貝 串
賘	貝 庒
賙	貝 周
賚	來 貝
賛	夫 夫 貝
賜	貝 易
賝	貝 罙
賞	龸 口 貝
賟	貝 典
賠	貝 咅
賡	庚 貝
賢	臤 貝
賣	士 買
賤	貝 戔
賥	貝 卒
賦	貝 武
賧	貝 炎
賨	宗 貝
賩	貝 宗
質	斦 貝
賫	十 人 人 冖 貝
賬	貝 長
賭	貝 者
賮	⺻ 灬 貝
賯	貝 旬 子
賰	貝 春
賱	貝 軍
賲	保 貝
賳	貝 哉
賴	束 負
賵	貝 冒
賶	貝 倉
賷	十 口 口 冖 貝
賸	月 龹 貝
賹	貝 益
賺	貝 兼
賻	貝 尃
購	貝 冓
賽	宀 甘 八 貝
賾	H 責
賿	貝 翏
贀	殹 貝
贁	貝 貝 攵
贂	貝 參
贃	貝 患
贄	執 貝
贅	敖 貝
贆	貝 猋
贇	斌 貝
贈	貝 曾
贉	貝 覃
贊	兟 貝
贋	雁 貝
贌	貝 菐
贍	貝 詹
贎	貝 萬
贏	吂 月 貝 凡
贐	貝 盡
贑	章 貢
贒	臣 忠 貝
贓	貝 臧
贔	貝 賏
贕	卵 賣
贖	貝 賣
贗	鴈 貝
贘	貝 賞
贙	虤 貝
贚	貝 龍
贛	章 夂 貢
贜	貝 藏
贠	厶 贝
赥	赤 欠
赨	赤 虫
赩	赤 色
赬	赤 貞
赮	赤 叚
赯	赤 唐
赱	土 丷 丶	# 特殊
赲	走 力
赸	走 山
赹	走 匀
赺	走 今
赻	走 少
赼	走 欠
赽	走 夬
赾	走 斤
赿	走 氏
趀	走 丿 Z 丨 丿
趂	走 尔
趃	走 失
趆	走 氐
趇	走 立
趈	走 占
趉	走 出
趌	走 吉
趍	走 多
趎	走 朱
趏	走 舌
趐	走 羽
趒	走 兆
趓	走 朵
趕	走 旱
趖	走 坐
趗	走 足
趘	走 尾
趙	走 肖
趚	走 束
趛	走 金
趜	走 匊
趝	走 念
趞	走 昔
趠	走 卓
趡	走 隹
趢	走 录
趤	走 宕
趥	走 酋
趦	走 咨
趧	走 是
趨	走 芻
趩	走 異
趪	走 黃
趫	走 喬
趬	走 堯
趭	走 焦
趮	走 喿
趰	走 爾
趲	走 贊
趶	足 于
趷	足 乞
趹	足 夬
趻	足 今
趽	足 方
跀	足 月
跁	足 巴
跅	足 斥
跇	足 世
跈	足 人 彡
跉	足 令
跊	足 未
跍	足 古
跒	足 可
跓	足 主
跔	足 句
跕	足 占
跘	足 半
跙	足 且
跜	足 尼
跠	足 夷
跡	足 亦
跢	足 多
跥	足 朶
跦	足 朱
跧	足 全
跩	足 曳
跭	足 夅
跮	足 至
跰	足 并
跲	足 合
跴	足 西
跼	足 局
跾	攸 足
跿	足 走
踀	足 足
踁	足 巠
踂	足 耳 乚
踃	足 肖
踄	足 步
踆	足 夋
踇	足 每
踈	足 束
踋	足 却
踍	足 孝
踎	足 否
踐	足 戔
踑	足 其
踓	足 隹
踕	足 疌
踖	足 昔
踗	足 念
踘	足 匊
踙	足 取
踚	足 侖
踛	足 坴
踜	足 夌
踠	足 宛
踡	足 卷
踤	足 卒
踥	足 妾
踧	足 叔
踨	足 从 止
踫	足 並
踭	足 争
踰	足 俞
踲	足 盾
踳	足 春
踴	足 勇
踷	足 者
踸	足 甚
踻	足 咼
踼	足 昜
踾	足 畐
踿	足 秋
蹃	足 若
蹆	足 退
蹌	足 倉
蹍	足 展
蹎	足 真
蹏	足 虒
蹓	足 留
蹔	斬 足
蹕	足 畢
蹖	足 舂
蹗	足 鹿
蹘	足 翏
蹛	足 帶
蹝	足 徙
蹞	足 頃
蹟	足 責
蹠	足 庶
蹡	足 將
蹣	足 廿 冂 丨 入 入
蹤	足 從
蹥	足 連
蹧	足 曹
蹨	足 然
蹪	足 貴
蹫	足 矞
蹮	足 西 大 巳
蹱	足 童
蹳	足 發
蹵	就 足
蹷	厥 足
蹸	足 粦
蹹	足 翕
蹺	足 堯
蹻	足 喬
躀	足 貫
躂	足 達
躃	足 辟
躄	辟 足
躆	足 豦
躈	足 敫
躉	萬 足
躊	足 壽
躋	足 齊
躌	足 舞
躍	足 翟
躎	足 爾
躑	足 鄭
躒	足 樂
躓	足 質
躕	足 廚
躖	足 幺 幺 一 幺 幺 丨 一	# 特殊
躗	衛 足
躘	足 龍
躙	足 閵
躚	足 遷
躛	衞 足
躝	足 闌
躟	足 襄
躠	薛 足
躡	足 聶
躢	足 闒
躣	足 瞿
躤	足 藉
躥	足 竄
躦	足 贊
躧	足 麗
躨	足 夔
躩	足 矍
躪	足 藺
躭	身 冘
躮	身 分
躰	身 本
躱	身 朶
躳	身 吕
躴	身 良
躵	身 忍
躶	身 果
躷	身 委
躸	身 奇
躹	身 匊
躻	身 空
躼	身 長
躽	身 匽
躾	身 美
躿	身 康
軀	身 區
軁	身 婁
軂	身 勞
軃	身 單
軄	身 戠
軅	身 雁
軆	身 豊
軇	身 壽
軈	身 應
軉	身 寶
車	FK
軋	車 乚
軌	車 九
軍	冖 車
軏	車 兀
軐	車 卂
軑	車 大
軒	車 干
軓	車 凡
軔	車 刃
軕	車 山
軖	車 王
軗	車 殳
軘	車 屯
軙	車 攴
軚	車 太
軛	車 厄
軜	車 内
軝	車 氏
軞	車 毛
軟	車 欠
軠	車 壬
軡	車 今
転	車 云
軣	車 V
軤	車 乎
軥	車 句
軦	車 兄
軧	車 氐
軨	車 令
軩	車 台
軪	車 幼
軫	車 人 彡
軬	厶 大 車
軭	車 匡
軮	車 央
軯	車 平
軰	北 車
軱	車 瓜
軲	車 古
軳	車 包
軴	車 主
軵	車 付
軶	車 戹
軷	車 犮
軸	車 由
軹	車 只
軺	車 召
軻	車 可
軼	車 失
軽	車 圣
軾	車 式
軿	車 并
輀	車 而
輁	車 共
輂	共 車
較	車 交
輄	車 光
輅	車 各
輆	車 亥
輇	車 全
輈	車 舟
載	𢦏 車
輊	車 至
輋	山 大 車
輌	車 両
輍	車 谷
輎	車 肖
輏	車 酉
輐	車 完
輑	車 君
輒	車 耳 乚
輓	車 免
輔	車 甫
輕	車 巠
輖	車 周
輗	車 兒
輘	車 夌
輙	車 取
輚	車 戔
輛	車 兩
輜	車 甾
輝	光 軍
輞	車 LD
輟	車 叕
輠	車 果
輡	車 臽
輢	車 奇
輣	車 朋
輤	車 青
輥	車 昆
輦	夫 夫 車
輧	車 幷
輨	車 官
輩	非 車
輪	車 侖
輫	車 非
輬	車 京
輭	車 耎
輮	車 柔
輯	車 咠
輰	車 昜
輱	車 咸
輲	車 耑
輳	車 奏
輴	車 盾
輵	車 曷
輶	車 酋
輷	車 訇
輸	車 俞
輹	車 复
輺	車 巛 一 田	# 特殊
輻	車 畐
輼	車 昷
輽	車 畚
輾	車 展
輿	臼 車 八
轀	車 囚 皿
轁	車 舀
轂	士 冖 一 車 殳
轃	車 秦
轄	車 害
轅	車 袁
轆	車 鹿
轇	車 翏
轈	車 巢
轉	車 專
轊	車 彗
轋	車 連
轌	車 雪
轍	車 育 攵
轎	車 喬
轏	車 孱
轐	車 菐
轑	車 尞
轒	車 賁
轓	車 番
轔	車 粦
轕	車 葛
轖	車 嗇
轗	車 感
轘	車 睘
轙	車 義
轚	車 凵 殳 車
轛	車 對
轜	車 需
轝	與 車
轞	車 監
轟	車 車 車
轠	車 畾
轡	糹 車 糹 口
轢	車 樂
轣	車 歷
轤	車 盧
轥	車 藺
辝	台 辛
辠	自 辛
辡	辛 辛
辢	束 辛
辤	受 辛
辥	屮 丿 Y 辛
辦	辛 力 辛
辧	辛 刀 辛
辪	止 丿 Y 辛
辬	辛 文 辛
辭	爪 龴 LD 辛	# 特殊
辮	辛 糸 辛
辯	辛 言 辛
農	曲 辰
辳	林 辰
辴	單 辰
辵	彡 止
辷	辶 一
辸	辶 乃
辺	辶 刀
辻	辶 十
込	辶 入
迀	辶 干
迃	辶 亏
迆	辶 也
迉	辶 尸
迊	辶 帀
迋	辶 王
迌	辶 月
迍	辶 屯
迏	辶 太
迒	辶 亢
迖	辶 犬
迗	辶 天
迚	辶 中
迠	辶 占
迡	辶 尼
迣	辶 世
迧	辶 申
迬	辶 主
迯	辶 外
迱	辶 它
迲	辶 去
迴	辶 回
迵	辶 同
迶	辶 有
迻	辶 多
迼	辶 吉
迾	辶 列
迿	辶 旬
逇	辶 地
逈	辶 向
逌	辶 卣
逎	辶 酉
逓	辶 乕
逕	辶 巠
逘	辶 矣
這	辶 言
逜	辶 吾
連	辶 車
逤	辶 沙
逥	辶 囬
逧	辶 谷
逨	辶 來
逩	辶 奔
逪	辶 昔
逫	辶 叕
逬	辶 幷
逰	辶 扌 𠂉 子
週	辶 周
進	辶 隹
逳	辶 育
逷	辶 易
逹	辶 幸
逺	辶 土 Z 氏	# 非“遠” 
逽	辶 若
逿	辶 昜
遀	辶 左 月
遃	辶 彦
遅	辶 尸 羊
遈	辶 是
遉	辶 貞
遊	辶 斿
運	辶 軍
遌	辶 咢
過	辶 咼
達	辶 土 羊
違	辶 韋
遖	辶 南
遙	辶 RS 缶	# 异于“遥”
遚	辶 叟
遜	辶 孫
遝	辶 眔
遞	辶 虒
遟	辶 屖
遠	辶 袁
遡	辶 朔
遤	辶 馬
遦	辶 貫
遧	辶 章
適	辶 啇
遪	辶 參
遫	辶 敕
遬	辶 欶
遯	辶 豚
遰	辶 帶
遱	辶 婁
遲	辶 犀
遳	辶 莝
遶	辶 堯
遷	辶 西 大 巳
選	辶 巽
遺	辶 貴
遻	辶 吅 屰
遼	辶 尞
遾	辶 筮
邁	辶 萬
還	辶 睘
邅	辶 亶
邆	辶 登
邇	辶 爾
邉	辶 自 穴 口
邊	辶 臱
邌	辶 黎
邍	辶 备 录
邎	辶 RS 言 系
邏	辶 羅
邐	辶 麗
邒	丁 阝
邔	己 阝
邖	山 阝
邚	女 阝
邜	夕 阝
邞	夫 阝
邟	亢 阝
邤	斤 阝
邥	冘 阝
邧	元 阝
邩	火 阝
邫	丰 邑
邭	句 阝
邷	瓦 阝
邼	匡 阝
郀	夸 阝
郂	亥 阝
郆	吉 阝
郉	幵 阝
郋	自 阝
郌	圭 邑
郍	舟 阝
郒	丶 艮 邑
郔	延 阝
郕	成 阝
郖	豆 阝
郘	吕 阝
郙	甫 阝
郞	良 阝
郟	夾 阝
郠	更 阝
郣	孛 阝
郥	貝 阝
郩	肴 阝
郬	青 阝
郮	周 阝
郰	取 阝
郱	并 阝
郲	來 阝
郳	兒 阝
郵	垂 阝
郶	咅 邑
郷	乡 艮 阝
郹	狊 阝
郺	多 邕
郻	目 Z 巛 阝	# 特殊
郼	韋 阝
鄁	背 阝
鄆	軍 阝
鄇	侯 阝
鄈	癸 阝
鄉	乡 郎
鄊	乡 耶
鄋	叟 阝
鄍	冥 阝
鄎	息 阝
鄏	辱 阝
鄐	畜 阝
鄒	芻 阝
鄓	臭 阝
鄔	烏 阝
鄕	乡 皀 阝
鄖	員 阝
鄛	巢 阝
鄝	翏 阝
鄟	專 阝
鄡	梟 阝
鄤	曼 阝
鄥	鳥 阝
鄦	無 阝
鄧	登 阝
鄨	敝 邑
鄩	尋 阝
鄪	費 阝
鄬	爲 阝
鄭	奠 阝
鄮	貿 阝
鄰	粦 阝
鄲	單 阝
鄳	黽 阝
鄴	業 阝
鄵	喿 阝
鄶	會 阝
鄷	豊 阝
鄸	夢 阝
鄺	廣 阝
鄻	輦 阝
鄼	賛 阝
鄽	廛 阝
鄾	憂 阝
鄿	蕇 阝
酀	燕 阝
酁	毚 阝
酄	雚 阝
酇	贊 阝
酈	麗 阝
酑	酉 于
酓	今 酉
酔	酉 卆
酕	酉 毛
酖	酉 冘
酘	酉 殳
酙	酉 斗
酛	酉 元
酜	酉 夫
酟	酉 占
酠	酉 可
酧	酉 守
酨	𢦏 酉
酫	酉 全
酭	酉 有
酳	酉 幺 月
酻	酉 孚
酼	酉 亠 厶 川
醀	酉 隹
醁	酉 录
醂	酉 林
醃	酉 奄
醄	酉 匋
醆	酉 戔
醈	酉 炎
醊	酉 叕
醎	酉 咸
醏	酉 者
醓	酉 冘 皿
醔	秋 酉
醕	酉 亯
醖	酉 昷
醗	酉 発
醘	酉 盍
醙	酉 叟
醜	酉 鬼
醝	酉 差
醞	酉 囚 皿
醟	𤇾 酉
醠	酉 盎
醡	酉 窄
醤	将 酉
醥	酉 票
醦	酉 參
醧	酉 區
醩	酉 曹
醫	殹 酉
醬	將 酉
醰	酉 覃
醱	酉 發
醲	酉 農
醳	酉 睪
醶	酉 僉
醷	酉 意
醸	酉 六 甘 氏
醹	酉 需
醻	酉 壽
醼	酉 燕
醽	酉 霝
醿	酉 縻
釀	酉 襄
釁	臼 同 酉 分
釂	酉 爵
釃	酉 麗
釄	酉 靡
釅	酉 嚴
釈	釆 尺
釋	釆 睪
钑	钅 及
铇	钅 包
铓	钅 芒
铔	钅 亚
铦	钅 舌
锠	钅 昌
釓	金 乚
釔	金 乙
釕	金 了
釖	金 刀
釗	金 刂
釘	金 丁
釙	金 卜
釚	金 九
釛	金 力
針	金 十
釞	金 入
釟	金 八
釠	金 几
釡	八 金
釢	金 乃
釣	金 勺
釤	金 彡
釥	金 小
釦	金 口
釧	金 川
釨	金 子
釩	金 凡
釪	金 于
釫	金 亏
釬	金 干
釭	金 工
釮	金 才
釯	金 亡
釰	金 刃
釱	金 大
釲	金 巳
釳	金 乞
釴	金 弋
釵	金 叉
釶	金 也
釷	金 土
釸	金 夕
釹	金 女
釺	金 千
釻	金 丸
釼	金 刄
釽	金 爪
釾	金 牙
釿	金 斤
鈀	金 巴
鈁	金 方
鈂	金 冘
鈃	金 开
鈄	金 斗
鈅	金 月
鈆	金 公
鈇	金 夫
鈈	金 不
鈉	金 内
鈊	金 心
鈋	金 化
鈌	金 夬
鈍	金 屯
鈎	金 勾
鈏	金 引
鈐	金 今
鈑	金 反
鈒	金 及
鈓	金 壬
鈔	金 少
鈕	金 丑
鈖	金 分
鈗	金 允
鈘	金 支
鈙	金 攴
鈚	金 比
鈛	金 戈
鈜	金 厷
鈝	金 牛
鈞	金 匀
鈟	金 弔
鈠	金 殳
鈡	金 中
鈢	金 木
鈣	金 丐
鈤	金 日
鈥	金 火
鈦	金 太
鈧	金 亢
鈨	金 元
鈩	金 户
鈪	金 厄
鈫	金 文
鈬	金 尺
鈭	此 金
鈮	金 尼
鈯	金 出
鈰	金 市
鈱	金 民
鈲	金 瓜
鈳	金 可
鈴	金 令
鈵	金 丙
鈶	金 台
鈷	金 古
鈸	金 犮
鈹	金 皮
鈺	金 玉
鈻	金 Y
鈼	金 乍
鈽	金 布
鈾	金 由
鈿	金 田
鉀	金 甲
鉁	金 入 彡
鉂	金 史
鉃	金 矢
鉄	金 失
鉅	金 巨
鉆	金 占
鉇	金 𠂉 也
鉈	金 它
鉉	金 玄
鉊	金 召
鉋	金 包
鉌	金 禾
鉍	金 必
鉎	金 生
鉏	金 且
鉐	金 石
鉑	金 白
鉒	金 主
鉓	金 𠂉 巾
鉔	金 匝
鉕	金 叵
鉖	金 冬
鉗	金 甘
鉘	金 弗
鉙	金 只
鉚	金 卯
鉛	金 几 口
鉜	金 付
鉝	金 立
鉞	金 戉
鉟	金 丕
鉠	金 央
鉡	金 半
鉢	金 本
鉣	金 去
鉤	金 句
鉥	金 术
鉦	金 正
鉧	金 母
鉨	金 尔
鉩	金 尒
鉪	金 世
鉫	金 加
鉬	金 目
鉭	金 旦
鉮	金 申
鉯	金 以
鉰	金 司
鉱	金 広
鉲	金 卡
鉳	金 北
鉵	金 虫
鉶	金 刑
鉷	金 共
鉸	金 交
鉹	金 多
鉺	金 耳
鉻	金 各
鉼	金 并
鉽	金 式
鉾	金 牟
鉿	金 合
銀	金 艮
銁	金 旬
銂	金 州
銃	金 充
銄	金 向
銅	金 同
銆	金 百
銇	金 耒
銈	金 圭
銉	金 聿
銊	金 戌
銋	金 任
銌	金 存
銍	金 至
銏	金 册
銐	列 金
銑	金 先
銒	金 幵
銓	金 全
銔	金 不 十
銕	金 夷
銖	金 朱
銗	金 后
銘	金 名
銙	金 夸
銚	金 兆
銛	金 舌
銜	行 金
銝	金 休
銞	旬 金
銟	金 山 巾
銠	金 老
銡	金 吉
銢	金 二 水
銣	金 如
銤	金 米
銥	金 衣
銦	金 因
銧	金 光
銨	金 安
銩	金 丢
銪	金 有
銫	金 色
銬	金 考
銭	金 HM
銯	金 糸
銰	金 艾
銱	金 吊
銲	金 旱
銳	金 兌
銴	折 金
銵	金 身
銶	金 求
銷	金 肖
銸	金 耳 乚
銹	金 秀
銺	壯 金
銻	金 弟
銼	金 坐
銽	金 氏 口
銾	金 汞
銿	金 甬
鋀	金 豆
鋁	金 吕
鋂	金 每
鋃	金 良
鋄	金 灭 又
鋅	金 辛
鋇	金 貝
鋉	金 束
鋊	金 谷
鋋	金 延
鋌	金 廷
鋍	金 孛
鋎	金 完
鋏	金 夾
鋐	金 宏
鋑	金 夋
鋒	金 夆
鋓	金 利
鋔	金 免
鋕	金 志
鋖	金 妥
鋗	金 肙
鋘	金 吴
鋙	金 吾
鋚	攸 金
鋛	金 串
鋜	金 足
鋝	金 寽
鋞	金 巠
鋟	金 彐 冖 又
鋠	金 辰
鋡	金 含
鋢	金 孚
鋣	金 邪
鋤	金 助
鋥	金 呈
鋦	金 局
鋧	金 見
鋨	金 我
鋩	金 芒
鋪	金 甫
鋫	利 金
鋬	扳 金
鋭	金 兑
鋮	金 成
鋯	金 告
鋰	金 里
鋱	金 忒
鋲	金 兵
鋳	金 寿
鋴	金 克
鋵	金 秃
鋶	金 亠 厶 川
鋷	金 取
鋸	金 居
鋹	金 長
鋺	金 宛
鋻	臤 金
鋼	金 LD
鋽	金 卓
鋾	金 匋
鋿	金 尚
錀	金 侖
錁	金 果
錂	金 夌
錃	波 金
錄	金 彔
錅	禾 勹 丿 金
錆	金 青
錇	金 咅
錈	金 卷
錉	金 昏
錊	金 卒
錋	金 朋
錌	金 岸
錍	金 卑
錎	金 臽
錏	金 亞
錐	金 隹
錑	金 戾
錒	金 阿
錓	金 羌
錔	金 沓
錕	金 昆
錖	叔 金
錗	金 委
錘	金 垂
錙	金 甾
錚	金 争
錛	金 奔
錜	金 念
錝	金 宗
錞	金 享
錟	金 炎
錠	金 定
錡	金 奇
錢	金 戔
錣	金 叕
錤	金 其
錥	金 育
錦	金 帛
錧	金 官
錨	金 苗
錩	金 昌
錪	金 典
錫	金 易
錬	金 東
錭	金 周
錮	金 固
錯	金 昔
錰	金 杰
錱	金 玨
録	金 录
錳	金 孟
錴	金 坴
錵	金 花
錶	金 表
錷	金 軋
錸	金 來
錹	金 肯
錺	金 芳
錻	金 武
錼	金 奈
錽	金 灭 夂
錿	金 虎
鍀	金 日 一 寸
鍁	金 欣
鍂	金 金
鍃	金 忽
鍄	金 京
鍅	金 法
鍆	金 門
鍇	金 皆
鍈	金 英
鍉	金 是
鍊	金 柬
鍋	金 咼
鍌	洗 金
鍍	金 度
鍎	金 盾
鍏	金 韋
鍐	金 凶 八 夂
鍑	金 复
鍒	金 柔
鍓	金 咠
鍔	金 咢
鍕	金 軍
鍖	金 甚
鍗	金 帝
鍘	金 則
鍙	洪 金
鍚	金 昜
鍛	金 段
鍜	金 叚
鍝	金 禺
鍞	金 貞
鍟	金 星
鍠	金 皇
鍡	金 畏
鍢	金 畐
鍣	金 苕
鍤	金 臿
鍥	金 契
鍦	金 施
鍧	金 訇
鍨	金 癸
鍩	金 若
鍫	秋 金
鍬	金 秋
鍭	金 侯
鍮	金 俞
鍯	金 怱
鍰	金 爰
鍱	金 枼
鍲	金 昬
鍳	臣 M 金
鍴	金 耑
鍵	金 建
鍶	金 思
鍷	金 奎
鍸	金 胡
鍹	金 宣
鍺	金 者
鍻	金 曷
鍼	金 咸
鍽	金 扁
鍾	金 重
鍿	金 巛 一 田	# 特殊
鎀	金 修
鎁	金 耶
鎂	金 美
鎃	金 派
鎄	金 哀
鎅	金 界
鎆	金 前
鎇	金 眉
鎈	金 差
鎉	金 日 羽
鎊	金 旁
鎋	金 害
鎌	金 兼
鎍	金 索
鎎	金 氣
鎐	金 爪 缶
鎑	金 盍
鎒	金 辱
鎓	金 翁
鎔	金 容
鎕	金 唐
鎖	金 小 貝
鎗	金 倉
鎘	金 鬲
鎙	金 朔
鎚	金 追
鎛	金 尃
鎜	般 金
鎝	金 荅
鎞	金 囟 比
鎟	金 桑
鎠	金 罡
鎡	金 兹
鎢	金 烏
鎣	𤇾 金
鎤	金 晃
鎥	條 金
鎦	金 留
鎧	金 豈
鎨	金 隼
鎩	金 殺
鎪	金 叟
鎫	金 NL 乂 八 夂
鎬	金 高
鎭	金 眞
鎮	金 真
鎯	金 郎
鎰	金 益
鎱	金 袁
鎲	金 党
鎳	金 臬
鎴	金 息
鎵	金 家
鎶	金 哥
鎷	金 馬
鎸	金 隽
鎹	金 送
鎺	金 祖
鎻	金 巛 貝
鎼	金 虍 手
鎽	金 峯
鎾	金 昷
鎿	金 拿
鏀	金 鹵
鏁	金 巢
鏂	金 區
鏃	金 族
鏄	金 專
鏅	金 脩
鏆	金 貫
鏇	金 旋
鏈	金 連
鏉	金 欶
鏋	金 廿 冂 丨 入 入
鏌	金 莫
鏍	金 累
鏎	金 畢
鏏	金 彗
鏐	金 翏
鏑	金 啇
鏒	金 參
鏓	金 悤
鏔	金 寅
鏕	金 鹿
鏗	金 堅
鏘	金 將
鏙	金 崔
鏚	金 戚
鏛	金 常
鏜	金 堂
鏝	金 曼
鏞	金 庸
鏟	金 産
鏠	金 逢
鏡	金 竟
鏢	金 票
鏣	金 庶
鏤	金 婁
鏥	金 宿
鏦	金 從
鏧	殸 金
鏨	斬 金
鏩	金 斬
鏪	金 曹
鏫	金 梨
鏬	金 虖
鏭	金 悉
鏮	金 康
鏯	金 爽
鏰	金 崩
鏱	金 章
鏲	金 牽
鏳	金 曾
鏴	金 路
鏵	金 華
鏶	金 集
鏷	金 菐
鏸	金 惠
鏹	金 强
鏺	金 發
鏻	金 粦
鏼	金 策
鏽	金 肅
鏾	金 散
鏿	金 棠
鐀	金 貴
鐁	金 斯
鐂	金 畱
鐃	金 堯
鐄	金 黄
鐅	敝 金
鐆	隊 金
鐇	金 番
鐈	金 喬
鐉	金 巽
鐊	金 陽
鐋	金 湯
鐌	金 象
鐍	金 矞
鐎	金 焦
鐏	金 尊
鐐	金 尞
鐑	金 結
鐒	金 勞
鐓	金 敦
鐔	金 覃
鐕	金 朁
鐖	金 幾
鐗	金 閒
鐘	金 童
鐙	金 登
鐚	金 惡
鐛	金 景
鐜	敦 金
鐝	金 厥
鐞	金 尋
鐟	金 替
鐠	金 普
鐡	金 𢦏 口 UA
鐢	棥 金
鐣	金 掌
鐤	金 鼎
鐥	金 善
鐦	金 開
鐧	金 間
鐨	金 費
鐩	金 遂
鐪	金 虜
鐫	金 雋
鐬	金 歲
鐭	金 奥
鐮	金 廉
鐯	金 著
鐰	金 喿
鐱	金 僉
鐲	金 蜀
鐳	金 雷
鐴	金 辟
鐵	金 𢦏 呈
鐶	金 睘
鐷	金 葉
鐸	金 睪
鐹	金 過
鐺	金 當
鐻	金 豦
鐼	金 賁
鐽	金 達
鐿	金 意
鑀	金 愛
鑁	金 OS 凵 八 夂
鑂	金 熏
鑃	金 翟
鑄	金 壽
鑅	金 榮
鑆	金 對
鑇	金 齊
鑈	金 爾
鑉	金 蓋
鑊	金 蒦
鑋	輕 金
鑌	金 賓
鑍	賏 金
鑎	金 匱
鑏	金 寧
鑐	金 需
鑑	金 監
鑒	臣 M 罒 金
鑓	金 遣
鑔	金 察
鑕	金 質
鑖	金 蔑
鑗	金 黎
鑘	金 畾
鑙	金 禾 尤 旨
鑚	金 賛
鑛	金 廣
鑜	金 賞
鑝	金 蓬	#** 特殊
鑞	金 巤
鑟	金 賣
鑠	金 樂
鑡	金 齒
鑢	金 慮
鑣	金 麃
鑤	金 暴
鑥	金 魯
鑦	金 賢
鑧	金 寬
鑨	金 龍
鑩	金 噩
鑪	金 盧
鑬	金 覧
鑭	金 闌
鑮	金 薄
鑯	金 韱
鑰	金 龠
鑱	金 毚
鑲	金 襄
鑳	金 蹇
鑴	金 巂
鑵	金 雚
鑶	金 藏
鑷	金 聶
鑸	金 壘
鑹	金 竄
鑺	金 瞿
鑻	金 攀
鑼	金 羅
鑽	金 贊
鑾	龻 金
鑿	丵 臼 殳 金
钀	金 獻
钁	金 矍
钂	金 黨
钃	金 屬
钄	金 蘭
長	CH
镸	CH	AAA
镹	镸 久
镺	镸 夭
镻	镸 失
镼	镸 屈
镽	镸 尞
镾	镸 爾
門	XD
閁	門 丿
閂	門 一
閃	門 人
閄	門 人
閅	門 丁
閆	門 三
閇	門 下
閈	門 干
閉	門 才
閊	門 山
開	門 开
閌	門 亢
閍	門 方
閎	門 厷
閏	門 王
閐	門 毛
閑	門 木
閒	門 月
間	門 日
閔	門 文
閕	門 牙
閖	門 水
閗	門 斗
閘	門 甲
閙	門 市
閚	門 立
閛	門 平
閜	門 可
閝	門 令
閞	門 弁
閟	門 必
閠	門 玉
閡	門 亥
関	門 关
閣	門 各
閤	門 合
閥	門 伐
閦	門 众
閧	門 共
閨	門 圭
閩	門 虫
閪	門 西
閫	門 困
閬	門 良
閭	門 吕
閮	門 廷
閯	門 沙
閰	門 臼
閱	門 兌
閲	門 兑
閳	門 車
閴	門 貝
閵	門 隹
閶	門 昌
閷	杀 閃
閸	門 亞
閹	門 奄
閺	門 旻
閻	門 臽
閼	門 於
閽	門 昏
閾	門 或
閿	門 受
闀	門 巷
闁	門 門
闂	門 卷
闃	門 狊
闄	門 要
闅	門 目 攴
闆	門 品
闇	門 音
闈	門 韋
闉	門 垔
闊	門 活
闋	門 癸
闌	門 柬
闍	門 者
闎	門 泉
闏	門 風
闐	門 真
闑	門 臬
闒	門 日 羽
闓	門 豈
闔	門 盍
闕	門 欮
闖	門 馬
闗	門 幺 幺 灬
闘	門 豆 寸
闙	門 啟
闚	門 規
闛	門 堂
關	門 幺 幺 丱
闝	門 敗
闞	門 敢
闟	門 翕
闠	門 貴
闡	門 單
闢	門 辟
闣	門 當
闤	門 睘
闥	門 達
闦	門 豊
闧	門 遠
闬	门 干
阓	门 贵
阛	门 睘
阞	阝 力
阠	阝 卂
阣	阝 乞
阤	阝 也
阥	阝 水
阦	阝 火
阧	阝 斗
阨	阝 厄
阩	阝 升
阫	阝 不
阬	阝 亢
阭	阝 允
阯	阝 止
阰	阝 比
阷	阝 正
阸	阝 戹
阹	阝 去
阺	阝 氐
阾	阝 令
陁	阝 𠂉 也
陃	阝 丙
陊	阝 多
陏	阝 有
陒	阝 危
陓	阝 夸
陖	阝 夋
陗	阝 肖
陘	阝 巠
陙	阝 辰
陚	阝 武
陜	阝 夾
陝	阝 大 入 入
陠	阝 甫
陣	阝 車
陥	阝 ⺈ 旧
陦	阝 寿
陫	阝 非
陭	阝 奇
陮	阝 隹
陯	阝 侖
陰	阝 侌
陱	阝 匊
陳	阝 東
陸	阝 坴
陹	阝 升 日
険	阝 亼 口 人	# 口 交
陻	阝 垔
陼	阝 者
陽	阝 昜
陾	阝 耎
陿	阝 匧
隀	阝 重
隁	阝 匽
隂	阝 人 镸
隄	阝 是
隇	阝 威
隉	阝 臼 工
隊	阝 丷 豕
隌	阝 音
階	阝 皆
隑	阝 豈
隒	阝 兼
隓	阝 左 左
隕	阝 員
隖	阝 烏
隚	阝 堂
際	阝 祭
隝	阝 鳥
隞	阝 敖
隟	阝 巢
隠	阝 爪 彐 心
隡	阝 産
隢	阝 堯
隣	阝 粦
隤	阝 貴
隥	阝 登
隦	阝 辟
隨	阝 遀
險	阝 僉
隫	阝 賁
隬	阝 爾
隭	阝 需
隮	阝 齊
隯	阝 壽
隱	阝 爪 工 彐 心
隲	阝 少 馬
隴	阝 龍
隵	阝 戲
隷	士 示 隶
隸	柰 隶
隻	隹 又
隿	弋 隹
雂	今 隹
雃	开 隹
雈	卝 隹
雋	隹 丨 Y 丨 𠃌
雐	虍 隹
雑	杂 隹
雓	余 隹
雔	隹 隹
雖	虽 隹
雗	龺 𠂉 隹
雘	丹 蒦
雙	隹 隹 又
雚	艹 吅 隹
雛	芻 隹
雜	亠 从 木 隹
雝	邕 隹
雞	奚 隹
雟	屮 隹 LD
雡	翏 隹
離	离 隹
難	廿 口 夫 隹
雤	臼 爻 隹
雥	隹 雔
雦	隹 隹 隹
雧	雥 木
雫	雨 下
雬	雨 木
雭	雨 及
雮	雨 毛
雰	雨 分
雲	雨 云
雴	雨 立
雵	雨 央
雸	雨 甘
雺	雨 矛
電	雨 日 乚	# 日 交
雼	雨 石
雽	雨 乎
雿	雨 兆
霂	雨 沐
霃	雨 沈
霊	雨 二 业
霋	雨 妻
霌	雨 周
霐	雨 泓
霑	雨 沾
霒	雲 今
霔	雨 注
霕	雲 屯
霗	雨 泠
霘	雨 洞
霙	雨 英
霚	雨 敄
霛	雨 弓 弓 弓
霝	雨 口 口 口
霟	雨 洪
霠	雨 立 今
霡	雨 脉
霢	雨 脈
霣	雨 員
霤	雨 留
霥	雨 冡
霦	雨 彬
霧	雨 務
霩	雨 郭
霫	雨 習
霬	雨 異
霮	雨 湛
霯	雨 登
霱	雨 矞
霳	雨 隆
霴	雲 隶
霵	雨 戢
霶	雨 滂
霷	雨 暘
霺	雨 微
霻	雨 豊
霼	雲 氣
霽	雨 齊
霿	雨 矛 夂 目
靀	雨 蒙
靁	雨 畾
靂	雨 歷
靃	雨 雔
靄	雨 謁
靅	雲 費
靆	雲 逮
靇	雨 龍
靈	霝 巫
靉	雲 愛
靊	雨 豐
靋	雨 瀝
靌	雨 寳
靍	雨 隹 鳥
靎	雨 鵭
靏	雨 鶴
靐	雷 雷 雷
靑	丰 月	#** 特殊；下从丹，取月不取円
靔	青 气
靕	正 青
靗	青 光
靘	青 色
靚	青 見
靜	青 爭
靝	青 氣
靟	非 毛
靣	丆 回
靤	面 包
靦	面 見
靧	面 貴
靨	厭 面
靪	革 丁
靫	革 叉
靭	革 刃
靮	革 勺
靯	革 土
靱	革 刄
靲	革 今
靵	革 丑
靷	革 引
靹	革 内
靻	革 且
靾	革 世
鞀	革 召
鞂	革 禾
鞃	革 弘
鞄	革 包
鞆	革 丙
鞇	革 因
鞈	革 合
鞉	革 兆
鞊	革 吉
鞌	安 革
鞎	革 艮
鞏	巩 革
鞐	革 卜 二 卜
鞓	革 呈
鞕	革 更
鞖	革 妥
鞗	亻 丨 夂 革
鞙	革 肙
鞚	革 空
鞛	革 咅
鞜	革 沓
鞝	革 尚
鞞	革 卑
鞟	革 享
鞢	革 枼
鞤	封 革
鞥	革 弇
鞦	革 秋
鞩	革 削
鞪	敄 革
鞰	革 昷
鞱	革 舀
鞵	革 奚
鞶	般 革
鞷	鬲 革
鞸	革 畢
鞹	革 郭
鞺	革 堂
鞻	革 婁
鞼	革 貴
鞽	革 喬
鞾	革 華
鞿	革 幾
韀	革 廌
韁	革 畺
韃	革 達
韄	革 蒦
韅	革 㬎
韆	革 遷
韇	革 賣
韈	革 蔑
韉	革 薦
韊	革 蘭
韋	X 口 MB
韌	韋 刃
韍	韋 犮
韎	韋 末
韏	龹 韋
韐	韋 合
韑	光 韋
韒	韋 肖
韓	龺 韋
韔	韋 長
韕	韋 享
韖	韋 柔
韗	韋 軍
韘	韋 枼
韙	是 韋
韚	韋 革
韛	韋 廿 丿 LD
韜	韋 舀
韝	韋 冓
韞	韋 昷
韟	韋 皋
韠	韋 畢
韡	韋 華
韢	韋 惠
韣	韋 蜀
韤	韋 蔑
韥	韋 賣
韮	艹 韭
韯	𢦏 韭
韰	歺 又 韭
韱	从 戈 韭
韲	亠 刀 丫 RH 韭
韴	音 帀
韷	音 出
韸	音 夆
韹	音 皇
韺	音 英
韻	音 員
韼	音 逢
韽	酓 音
韾	殸 音
響	鄉 音
頀	音 蒦
颒	水 廾 页
颕	匕 示 页
颣	米 糸 页
頁	GO
頂	丁 頁
頃	匕 頁
頄	九 頁
項	工 頁
順	川 頁
頇	干 頁
須	彡 頁
頉	止 頁
頊	王 頁
頋	厄 頁
頌	公 頁
頍	支 頁
頎	斤 頁
頏	亢 頁
預	予 頁
頑	元 頁
頒	分 頁
頓	屯 頁
頔	由 頁
頕	占 頁
頖	半 頁
頗	皮 頁
領	令 頁
頙	正 頁
頚	圣 頁
頛	耒 頁
頜	合 頁
頝	交 頁
頞	安 頁
頟	各 頁
頠	危 頁
頡	吉 頁
頢	舌 頁
頣	臣 頁
頤	H 頁
頥	丨 臣 頁
頦	亥 頁
頧	丿 Y 頁
頨	羽 頁
頩	并 頁
頪	米 頁
頫	兆 頁
頬	夹 頁
頭	豆 頁
頮	水 廾 頁
頯	RS 廾 頁
頰	夾 頁
頱	寽 頁
頲	廷 頁
頳	赤 頁
頴	匕 示 頁
頵	君 頁
頶	告 頁
頷	含 頁
頸	巠 頁
頹	禿 頁	# 异于“頽”
頺	秀 頁
頻	步 頁
頼	束 頁
頽	秃 頁
頾	須 此
頿	彡 此 頁
顀	隹 頁
顁	定 頁
顂	來 頁
顃	炎 頁
顄	函 頁
顅	肩 頁
顆	果 頁
顇	卒 頁
顈	匕 糸 頁
顉	金 頁
顊	阜 頁
顋	思 頁
題	是 頁
額	客 頁
顎	咢 頁
顏	彥 頁
顐	軍 頁
顑	咸 頁
顒	禺 頁
顓	耑 頁
顔	彦 頁
顕	显 頁
顖	恖 頁
顗	豈 頁
願	原 頁
顙	桑 頁
顚	眞 頁
顛	真 頁
顜	冓 頁
顝	骨 頁
類	米 犬 頁
顟	翏 頁
顠	票 頁
顡	豙 頁
顢	廿 冂 丨 入 入 頁
顣	戚 頁
顤	堯 頁
顥	景 頁
顦	焦 頁
顧	雇 頁
顨	頁 頁 丌
顩	僉 頁
顪	歲 頁
顫	亶 頁
顬	需 頁
顭	夢 頁
顮	賓 頁
顯	㬎 頁
顰	頻 卑
顱	盧 頁
顲	炎 亠 回 頁
顳	聶 頁
顴	雚 頁
風	QI
颩	風 彡
颪	下 風
颫	風 夫
颬	風 牙
颭	風 占
颮	風 包
颯	立 風
颰	風 犮
颱	風 台
颲	風 列
颳	風 舌
颴	風 𠂉 疋
颵	風 肖
颶	風 具
颷	風 炎
颸	風 思
颹	風 韋
颺	風 昜
颻	爪 缶 風
颼	風 叟
颽	豈 風
颾	風 蚤
颿	馬 風
飀	風 留
飁	習 風
飂	風 翏
飃	風 票
飄	票 風
飅	風 畱
飆	猋 風
飇	風 猋
飈	風 焱
飉	風 尞
飊	焱 風
飋	風 瑟
飌	雚 風
飍	風 風 風
飖	爪 缶 风
飛	飞 丿 飞 ND	# 特殊
飜	番 飛
飝	飛 飛 飛
饤	饣 丁
饦	饣 乇
饾	饣 豆
馂	饣 夋
馎	饣 尃
飡	冫 食
飢	食 几
飣	食 丁
飤	食 人
飥	食 乇
飦	食 干
飩	食 屯
飪	食 壬
飫	食 夭
飬	龹 良
飭	食 𠂉 力
飮	食 欠	# 异于“飲”
飯	食 反
飰	食 卞
飱	歹 食
飲	食 欠
飳	食 主
飴	食 台
飵	食 乍
飶	食 必
飷	食 且
飸	号 食
飹	食 卯
飺	此 食
飻	食 人 彡
飼	食 司
飽	食 包
飾	食 𠂉 巾
飿	食 出
餀	食 艾
餁	食 任
餂	食 舌
餃	食 交
餄	食 合
餅	食 并
餆	食 兆
餇	食 同
餈	次 食
餉	食 向
養	UC 良
餋	龹 食
餌	食 耳
餎	食 各
餏	食 衣
餑	食 孛
餒	食 妥
餓	食 我
餔	食 甫
餕	食 夋
餖	食 豆
餗	食 束
餘	食 余
餙	食 希
餚	食 肴
餛	食 昆
餜	食 果
餝	食 芳
餞	食 戔
餟	食 叕
餠	食 幷
餡	食 臽
餢	食 咅
餣	食 奄
餤	食 炎
餥	非 食
餦	食 長
餧	食 委
館	食 官
餩	食 人 亥
餪	食 耎
餫	食 軍
餬	食 胡
餭	食 皇
餯	食 彖
餰	食 衍
餱	食 侯
餲	食 曷
餳	食 昜
餴	食 奔
餵	食 畏
餶	食 骨
餷	食 查
餸	食 送
餹	食 唐
餺	食 尃
餻	食 羔
餼	食 氣
餽	食 鬼
餾	食 留
餿	食 叟
饀	食 舀
饁	食 盍
饂	食 昷
饃	食 莫
饄	食 堂
饅	食 曼
饆	食 畢
饇	食 區
饈	食 羞
饉	食 堇
饊	食 散
饋	食 貴
饌	食 巽
饍	食 善
饎	食 喜
饏	敢 食
饐	食 壹
饑	食 幾
饒	食 堯
饓	食 棠
饖	食 歲
饗	鄉 食
饘	食 亶
饙	食 賁
饚	食 蓋
饛	食 蒙
饜	厭 食
饝	食 磨
饞	食 毚
饟	食 襄
饠	食 羅
饡	食 贊
饢	食 囊
馚	香 分
馛	香 犮
馜	香 尼
馟	香 孚
馠	香 含
馡	香 非
馢	香 戔
馣	香 奄
馤	香 曷
馦	香 兼
馩	香 賁
馪	香 賓
馫	香 香 香
骔	马 宗
馬	CU
馭	馬 又
馮	冫 馬
馯	馬 干
馰	馬 勺
馱	馬 大
馲	馬 乇
馳	馬 也
馴	馬 川
馵	馬 廾
馶	馬 支
馷	馬 巿
馸	馬 斤
馹	馬 日
馺	馬 及
馻	馬 允
馼	馬 文
馽	馬 中
馾	馬 冘
馿	馬 户
駀	馬 尤
駁	馬 爻
駂	匕 十 馬
駃	馬 夬
駄	馬 太
駅	馬 尺
駆	馬 区
駇	馬 攵
駈	馬 丘
駉	馬 LD
駊	馬 皮
駋	馬 召
駌	夗 馬
駍	馬 平
駎	馬 由
駏	馬 巨
駐	馬 主
駑	奴 馬
駒	馬 句
駓	馬 丕
駔	馬 且
駕	加 馬
駖	馬 令
駗	馬 人 彡
駘	馬 台
駙	馬 付
駚	馬 央
駛	馬 史
駜	馬 必
駝	馬 它
駞	馬 𠂉 也
駟	馬 四
駠	馬 卯
駡	吅 馬
駢	馬 并
駣	馬 兆
駤	馬 至
駥	馬 戎
駦	龹 馬
駧	馬 同
駨	馬 旬
駩	馬 全
駪	馬 先
駫	馬 光
駬	馬 耳
駭	馬 亥
駮	馬 交
駯	馬 朱
駰	馬 因
駱	馬 各
駲	馬 州
駳	馬 延
駴	馬 戒
駵	馬 丣
駶	馬 局
駷	馬 束
駸	馬 彐 冖 又
駹	馬 尨
駺	馬 良
駻	馬 旱
駼	馬 余
駽	馬 肙
駾	馬 兑
駿	馬 夋
騀	馬 我
騁	馬 甹
騂	馬 辛
騃	馬 矣
騄	馬 录
騅	馬 隹
騆	馬 周
騇	馬 舍
騈	馬 幷
騉	馬 昆
騊	馬 匋
騋	馬 來
騌	馬 宗
騍	馬 果
騎	馬 奇
騏	馬 其
騐	馬 念
騑	馬 非
騒	馬 又 虫
験	馬 亼 口 人	# 口 交
騔	馬 曷
騕	馬 要
騖	敄 馬
騗	扁 馬
騘	馬 怱
騙	馬 扁
騚	馬 前
騛	馬 飛
騜	馬 皇
騝	馬 建
騞	馬 砉
騟	馬 俞
騠	馬 是
騡	馬 泉
騢	馬 叚
騣	馬 凶 八 夂
騤	馬 癸
騥	馬 柔
騦	馬 思
騧	馬 咼
騨	馬 単
騩	馬 鬼
騪	馬 叟
騫	宀 甘 八 馬
騬	馬 乘
騭	陟 馬
騮	馬 留
騯	馬 旁
騰	月 駦
騱	馬 奚
騲	馬 草
騳	馬 馬
騴	馬 晏
騵	馬 原
騶	馬 芻
騷	馬 蚤
騸	馬 扇
騹	馬 堇
騺	執 馬
騻	馬 爽
騼	馬 鹿
騽	馬 習
騾	馬 累
騿	馬 章
驀	莫 馬
驁	敖 馬
驂	馬 參
驃	馬 票
驄	馬 悤
驅	馬 區
驆	馬 畢
驇	埶 馬
驈	馬 矞
驉	馬 虚
驊	馬 華
驋	馬 發
驌	馬 肅
驍	馬 堯
驎	馬 粦
驏	馬 孱
驐	馬 敦
驑	馬 畱
驒	馬 單
驓	馬 曾
驔	馬 覃
驕	馬 喬
驖	馬 𢦏 呈
驗	馬 僉
驘	吂 月 馬 凡
驙	馬 亶
驚	敬 馬
驛	馬 睪
驜	馬 業
驝	馬 槖
驞	馬 賓
驟	馬 聚
驠	馬 燕
驡	龍 馬
驢	馬 盧
驣	馬 駦
驤	馬 襄
驥	馬 冀
驦	馬 霜
驧	馬 鞠
驨	馬 巂
驩	馬 雚
驪	馬 麗
驫	馬 馬 馬
骩	骨 九
骪	骨 凡
骫	骨 丸
骬	骨 于
骭	骨 干
骮	骨 弋
骯	骨 亢
骲	骨 包
骳	骨 皮
骴	骨 此
骵	骨 本
骹	骨 交
骻	骨 夸
骽	骨 妥
骾	骨 更
骿	骨 并
髄	骨 迶
髆	骨 尃
髇	骨 高
髈	骨 旁
髉	骨 隺
髊	骨 差
髍	骨 麻
髏	骨 婁
髐	骨 堯
髒	骨 葬
體	骨 豊
髕	骨 賓
髖	骨 寬
髗	骨 盧
髙	亠 KD LD
髚	高 亢
髛	高 尻
髜	高 昇
髝	高 勞
髞	高 喿
髠	髟 几
髣	髟 方
髤	髟 木
髥	髟 冄
髧	髟 冘
髨	髟 元
髩	髟 丏
髪	髟 友
髬	髟 丕
髮	髟 犮
髰	髟 世
髱	髟 包
髲	髟 皮
髳	髟 矛
髴	髟 弗
髵	髟 而
髶	髟 耳
髷	髟 曲
髸	髟 共
髺	髟 舌
髼	髟 夆
髾	髟 肖
髿	髟 沙
鬀	髟 弟
鬁	髟 利
鬂	髟 兵
鬄	髟 易
鬅	髟 朋
鬆	髟 松
鬇	髟 争
鬉	髟 凶 八 夂
鬊	髟 春
鬋	髟 前
鬌	髟 左 月
鬍	髟 胡
鬎	髟 剌
鬐	髟 耆
鬑	髟 兼
鬔	髟 逢
鬕	髟 莫
鬖	髟 參
鬗	髟 廿 冂 丨 入 入
鬙	髟 曾
鬚	髟 須
鬛	髟 囗 乂 ZD
鬜	髟 閒
鬝	髟 間
鬞	髟 農
鬠	髟 會
鬡	髟 寧
鬢	髟 賓
鬤	髟 襄
鬥	CC
鬦	鬥 斗
鬧	鬥 市
鬨	鬥 共
鬩	鬥 兒
鬪	鬥 豆 寸
鬫	鬥 敢
鬬	鬥 斲
鬭	鬥 斲
鬮	鬥 龜
鬰	棥 冖 鬯 彡
鬱	木 缶 木 冖 鬯 彡
鬳	虍 鬲
鬴	鬲 甫
鬵	兓 鬲
鬸	鬲 留
鬹	規 鬲
鬺	鬲 𠂉 昜
鬽	鬼 彡
鬾	鬼 支
鬿	鬼 斤
魀	鬼 介
魊	鬼 或
魌	鬼 其
魎	鬼 兩
魐	鬼 兼
魒	鬼 票
魓	鬼 畢
魕	鬼 幾
魖	鬼 虚
魗	壽 鬼
魘	厭 鬼
魙	漸 鬼
鲄	鱼 可
鲓	鱼 考
魚	R
魛	魚 刀
魜	魚 人
魝	魚 刂
魞	魚 入
魟	魚 工
魠	魚 乇
魡	魚 勺
魢	魚 己
魣	魚 予
魤	魚 化
魥	魚 及
魦	魚 少
魧	魚 亢
魨	魚 屯
魩	魚 勿
魪	魚 介
魫	魚 冘
魬	魚 反
魭	魚 元
魮	魚 比
魯	魚 日
魰	魚 文
魱	魚 互
魲	魚 户
魳	魚 帀
魴	魚 方
魵	魚 分
魶	魚 内
魷	魚 尤
魸	魚 片
魹	魚 毛
魺	魚 可
魻	魚 甲
魼	魚 去
魽	魚 甘
魾	魚 丕
魿	魚 令
鮀	魚 它
鮁	魚 犮
鮂	魚 囚
鮃	魚 平
鮄	魚 弗
鮅	魚 必
鮆	此 魚
鮇	魚 未
鮈	魚 句
鮉	魚 召
鮊	魚 白
鮋	魚 由
鮌	魚 玄
鮍	魚 皮
鮎	魚 占
鮏	魚 生
鮐	魚 台
鮑	魚 包
鮒	魚 付
鮓	魚 乍
鮔	魚 巨
鮕	魚 古
鮖	魚 石
鮗	魚 冬
鮘	魚 代
鮙	魚 羽
鮚	魚 吉
鮛	魚 尗
鮜	魚 后
鮝	龹 魚
鮞	魚 而
鮟	魚 安
鮠	魚 危
鮡	魚 兆
鮢	魚 朱
鮣	魚 印
鮤	列 魚
鮥	魚 各
鮦	魚 同
鮧	魚 夷
鮨	魚 旨
鮩	魚 并
鮪	魚 有
鮫	魚 交
鮬	魚 夸
鮭	魚 圭
鮮	魚 羊
鮯	魚 合
鮰	魚 回
鮱	魚 老
鮲	魚 伏
鮳	魚 考
鮴	魚 休
鮵	魚 兑
鮶	魚 君
鮷	魚 弟
鮸	魚 免
鮹	魚 肖
鮺	羊 魚
鮻	魚 夋
鮼	魚 彐 冖 又
鮽	魚 余
鮾	魚 妥
鮿	魚 耳 乚
鯀	魚 系
鯁	魚 更
鯂	魚 酉
鯃	魚 吾
鯄	魚 求
鯅	魚 延
鯆	魚 甫
鯇	魚 完
鯈	亻 丨 夂 魚
鯉	魚 里
鯊	沙 魚
鯋	魚 沙
鯌	魚 告
鯍	魚 亠 厶 川
鯎	魚 成
鯏	魚 利
鯐	魚 走
鯑	魚 希
鯒	魚 甬
鯓	魚 身
鯔	魚 甾
鯕	魚 其
鯖	魚 青
鯗	UC 魚
鯘	魚 委
鯙	魚 享
鯚	魚 季
鯛	魚 周
鯜	魚 妾
鯝	魚 固
鯞	魚 帚
鯟	魚 東
鯠	魚 來
鯡	魚 非
鯢	魚 兒
鯣	魚 易
鯤	魚 昆
鯥	魚 坴
鯦	魚 咎
鯧	魚 昌
鯨	魚 京
鯩	魚 侖
鯪	魚 夌
鯫	魚 取
鯬	禾 勹 丿 魚
鯭	魚 孟
鯮	魚 宗
鯯	魚 制
鯰	魚 念
鯱	魚 虎
鯲	魚 於
鯳	魚 底
鯴	魚 虱
鯵	魚 参
鯶	魚 軍
鯷	魚 是
鯸	魚 侯
鯹	魚 星
鯺	魚 者
鯻	魚 剌
鯼	魚 凶 八 夂
鯽	魚 即
鯾	魚 便
鯿	魚 扁
鰀	魚 爰
鰁	魚 泉
鰂	魚 則
鰃	魚 畏
鰄	魚 威
鰅	魚 禺
鰆	魚 春
鰇	魚 柔
鰈	魚 枼
鰉	魚 皇
鰊	魚 柬
鰋	魚 匽
鰌	魚 酋
鰍	魚 秋
鰎	魚 建
鰏	魚 畐
鰐	魚 咢
鰑	魚 昜
鰒	魚 复
鰓	魚 思
鰔	魚 咸
鰕	魚 叚
鰖	魚 左 月
鰗	魚 胡
鰘	魚 室
鰙	魚 若
鰚	魚 宣
鰛	魚 昷
鰜	魚 兼
鰝	魚 高
鰞	魚 烏
鰟	魚 旁
鰠	魚 蚤
鰡	魚 留
鰢	魚 馬
鰣	魚 時
鰤	魚 師
鰥	魚 眔
鰦	魚 兹
鰧	月 鮝
鰨	魚 日 羽
鰩	魚 爪 缶
鰪	魚 盍
鰫	魚 容
鰬	魚 虔
鰭	魚 耆
鰮	魚 囚 皿
鰯	魚 弱
鰰	魚 神
鰱	魚 連
鰲	敖 魚
鰳	魚 勒
鰴	彳 山 一 魚 攵
鰵	敏 魚
鰶	魚 祭
鰷	魚 條
鰸	魚 區
鰹	魚 堅
鰺	魚 參
鰻	魚 曼
鰼	魚 習
鰽	魚 曹
鰾	魚 票
鰿	魚 責
鱀	既 魚
鱁	魚 逐
鱂	魚 將
鱃	魚 羞
鱄	魚 專
鱅	魚 庸
鱆	魚 章
鱇	魚 康
鱈	魚 雪
鱉	敝 魚
鱊	魚 矞
鱋	魚 虚
鱌	魚 象
鱍	魚 發
鱎	魚 喬
鱏	魚 覃
鱐	魚 肅
鱑	魚 黄
鱒	魚 尊
鱓	魚 單
鱔	魚 善
鱕	魚 番
鱖	魚 厥
鱗	魚 粦
鱘	魚 尋
鱙	魚 堯
鱚	魚 喜
鱛	魚 曾
鱜	魚 鄉
鱝	魚 賁
鱞	魚 睘
鱟	臼 爻 魚
鱠	魚 會
鱡	魚 賊
鱢	魚 喿
鱣	魚 亶
鱤	魚 感
鱥	魚 歲
鱦	魚 黽
鱧	魚 豊
鱨	魚 嘗
鱩	魚 雷
鱪	魚 暑
鱫	魚 愛
鱬	魚 需
鱭	魚 齊
鱮	魚 與
鱯	魚 蒦
鱰	魚 署
鱱	魚 厲
鱲	魚 巤
鱳	魚 樂
鱴	魚 蔑
鱵	魚 箴
鱶	魚 養
鱷	魚 噩
鱸	魚 盧
鱹	魚 雚
鱺	魚 麗
鱻	魚 魚 魚
鸴	VD 冖 鸟
鹓	宛 鸟
鹥	殹 鸟
鳥	RZ
鳦	鳥 乙
鳧	鳥 几
鳨	鳥 力
鳩	九 鳥
鳪	卜 鳥
鳫	厂 鳥
鳬	鳥 几
鳭	刀 鳥
鳮	又 鳥
鳯	QD 鳥
鳰	入 鳥
鳱	干 鳥
鳲	尸 鳥
鳳	几 一 鳥
鳴	口 鳥
鳵	卂 鳥
鳶	弋 鳥
鳷	支 鳥
鳸	户 鳥
鳹	今 鳥
鳺	夫 鳥
鳻	分 鳥
鳼	文 鳥
鳽	开 鳥
鳾	帀 鳥
鳿	王 鳥
鴀	不 鳥
鴁	夭 鳥
鴂	夬 鳥
鴃	鳥 夬
鴄	匹 鳥
鴅	丹 鳥
鴆	冘 鳥
鴇	匕 十 鳥
鴈	厂 亻 鳥
鴉	牙 鳥
鴊	正 鳥
鴋	方 鳥
鴌	天 鳥
鴍	文 鳥
鴎	区 鳥
鴏	鳥 代
鴐	加 鳥
鴑	奴 鳥
鴒	令 鳥
鴓	必 鳥
鴔	乏 鳥
鴕	鳥 它
鴖	民 鳥
鴗	立 鳥
鴘	弁 鳥
鴙	矢 鳥
鴚	鳥 可
鴛	夗 鳥
鴜	此 鳥
鴝	句 鳥
鴞	号 鳥
鴟	氐 鳥
鴠	旦 鳥
鴡	且 鳥
鴢	幼 鳥
鴣	古 鳥
鴤	鳥 冬
鴥	鳥 穴
鴦	央 鳥
鴧	宂 鳥
鴨	甲 鳥
鴩	失 鳥
鴪	穴 鳥
鴫	田 鳥
鴬	VD 冖 鳥
鴭	丿 Y 鳥
鴮	夸 鳥
鴯	而 鳥
鴰	舌 鳥
鴱	艾 鳥
鴲	旨 鳥
鴳	安 鳥
鴴	行 鳥
鴵	兆 鳥
鴶	吉 鳥
鴷	列 鳥
鴸	朱 鳥
鴹	羊 鳥
鴺	夷 鳥
鴻	江 鳥
鴼	鳥 各
鴽	如 鳥
鴾	牟 鳥
鴿	合 鳥
鵀	任 鳥
鵁	交 鳥
鵂	休 鳥
鵃	舟 鳥
鵄	至 鳥
鵅	各 鳥
鵆	行 鳥
鵇	年 鳥
鵈	耳 鳥
鵉	亦 鳥
鵊	夾 鳥
鵋	忌 鳥
鵌	鳥 余
鵍	完 鳥
鵎	妥 鳥
鵏	甫 鳥
鵐	巫 鳥
鵑	肙 鳥
鵒	谷 鳥
鵓	孛 鳥
鵔	鳥 夋
鵕	夋 鳥
鵖	艮 鳥
鵗	希 鳥
鵘	君 鳥
鵙	貝 鳥
鵚	秃 鳥
鵛	巠 鳥
鵜	弟 鳥
鵝	我 鳥
鵞	我 鳥
鵟	狂 鳥
鵠	告 鳥
鵡	武 鳥
鵢	身 鳥
鵣	束 鳥
鵤	角 鳥
鵥	判 鳥
鵦	鳥 录
鵧	并 鳥
鵨	舍 鳥
鵩	服 鳥
鵪	奄 鳥
鵫	卓 鳥
鵬	朋 鳥
鵭	金 鳥
鵮	臽 鳥
鵯	卑 鳥
鵰	周 鳥
鵱	坴 鳥
鵲	昔 鳥
鵳	肩 鳥
鵴	匊 鳥
鵵	兔 鳥
鵶	亞 鳥
鵷	宛 鳥
鵸	奇 鳥
鵹	禾 勹 丿 鳥
鵺	夜 鳥
鵻	鳥 隹
鵼	空 鳥
鵽	叕 鳥
鵾	昆 鳥
鵿	鳥 昇
鶀	鳥 其
鶁	京 鳥
鶂	兒 鳥
鶃	鳥 兒
鶄	青 鳥
鶅	甾 鳥
鶆	來 鳥
鶇	東 鳥
鶈	妻 鳥
鶉	享 鳥
鶊	庚 鳥
鶋	居 鳥
鶌	屈 鳥
鶍	易 鳥
鶎	宗 鳥
鶏	爪 夫 鳥
鶐	述 鳥
鶑	炏 鳥
鶒	勅 鳥
鶓	苗 鳥
鶔	柔 鳥
鶕	音 鳥
鶖	秋 鳥
鶗	是 鳥
鶘	胡 鳥
鶙	帝 鳥
鶚	咢 鳥
鶛	皆 鳥
鶜	茅 鳥
鶝	畐 鳥
鶞	盾 鳥
鶟	突 鳥
鶠	匽 鳥
鶡	曷 鳥
鶢	爰 鳥
鶣	扁 鳥
鶤	軍 鳥
鶥	眉 鳥
鶦	胡 鳥
鶧	英 鳥
鶨	彖 鳥
鶩	敄 鳥
鶪	狊 鳥
鶫	柬 鳥
鶬	倉 鳥
鶭	紡 鳥
鶮	高 鳥
鶯	𤇾 鳥
鶰	員 鳥
鶱	宀 甘 八 鳥
鶲	翁 鳥
鶳	鳥 師
鶴	隺 鳥
鶵	芻 鳥
鶶	唐 鳥
鶷	害 鳥
鶸	弱 鳥
鶹	留 鳥
鶺	脊 鳥
鶻	骨 鳥
鶼	兼 鳥
鶽	隼 鳥
鶾	龺 𠂉 鳥
鶿	兹 鳥
鷀	兹 鳥
鷁	益 鳥
鷂	爪 缶 鳥
鷃	晏 鳥
鷄	奚 鳥
鷅	栗 鳥
鷆	眞 鳥
鷇	士 冖 一 鳥 殳
鷈	鳥 虒
鷉	虒 鳥
鷊	鬲 鳥
鷋	荼 鳥
鷌	鳥 馬
鷍	臬 鳥
鷎	皋 鳥
鷏	真 鳥
鷐	晨 鳥
鷑	笠 鳥
鷒	專 鳥
鷓	庶 鳥
鷔	敖 鳥
鷕	唯 鳥
鷖	殹 鳥
鷗	區 鳥
鷘	敕 鳥
鷙	執 鳥
鷚	翏 鳥
鷛	庸 鳥
鷜	婁 鳥
鷝	畢 鳥
鷞	爽 鳥
鷟	族 鳥
鷠	魚 鳥
鷡	無 鳥
鷢	厥 鳥
鷣	覃 鳥
鷤	單 鳥
鷥	絲 鳥
鷦	焦 鳥
鷧	壹 鳥
鷨	華 鳥
鷩	敝 鳥
鷪	目 目 冖 鳥
鷫	肅 鳥
鷬	黄 鳥
鷭	番 鳥
鷮	喬 鳥
鷯	尞 鳥
鷰	廿 丬 口 匕 鳥
鷱	臯 鳥
鷲	就 鳥
鷳	閒 鳥
鷴	閑 鳥
鷵	屠 鳥
鷶	買 鳥
鷷	尊 鳥
鷸	矞 鳥
鷹	广 亻 隹 鳥
鷺	路 鳥
鷻	鳥 敦
鷼	間 鳥
鷽	臼 爻 鳥
鷾	意 鳥
鷿	辟 鳥
鸀	蜀 鳥
鸁	吂 月 鳥 凡
鸂	溪 鳥
鸃	鳥 義
鸄	敫 鳥
鸅	睪 鳥
鸆	虞 鳥
鸇	亶 鳥
鸈	業 鳥
鸉	楊 鳥
鸊	辟 鳥
鸋	寧 鳥
鸌	鳥 蒦
鸍	爾 鳥
鸎	賏 鳥
鸏	蒙 鳥
鸐	翟 鳥
鸑	獄 鳥
鸒	與 鳥
鸓	畾 鳥
鸔	鳥 暴
鸕	盧 鳥
鸖	霍 鳥
鸗	龍 鳥
鸘	霜 鳥
鸙	龠 鳥
鸚	嬰 鳥
鸛	雚 鳥
鸜	瞿 鳥
鸝	麗 鳥
鸞	龻 鳥
鹵	卜 囗 OS
鹶	鹵 今
鹷	鹵 令
鹸	鹵 亼 口 人	# 口 交
鹹	鹵 咸
鹺	鹵 差
鹻	鹵 兼
鹼	鹵 僉
鹽	臣 𠂉 鹵 皿
麁	⺈ 鹿
麃	鹿 灬
麄	分 鹿
麅	鹿 包
麆	鹿 且
麉	干 干 鹿
麊	米 鹿
麌	鹿 吴
麍	鹿 亠 厶 川
麎	鹿 辰
麏	鹿 君
麐	鹿 吝
麔	鹿 咎
麕	鹿 囷
麗	一 LD 一 LD 鹿
麘	鹿 香
麙	鹿 咸
麚	鹿 叚
麛	鹿 弭
麜	鹿 栗
麞	鹿 章
麠	鹿 畺
麡	鹿 齊
麢	鹿 霝
麣	鹿 嚴
麤	鹿 鹿 鹿
麥	來 夕
麧	麥 乞
麨	麥 少
麩	麥 夫
麪	麥 丏
麫	麥 丐
麬	麥 皮
麭	麥 包
麮	麥 去
麯	麥 曲
麰	麥 牟
麱	麥 甫
麲	麥 見
麳	麥 來
麵	麥 面
麶	麥 离
麷	麥 豐
麺	麦 面
麼	麻 幺
麿	麻 吕
黀	麻 取
黁	麻 香
黂	麻 賁
黃	廿 一 由 八	# 异于“黄”
黅	黄 今
黆	黄 冘
黈	黄 主
黊	黄 圭
黋	光 黄
黌	臼 爻 黄
黐	黍 离
黒	里 灬	# 非“黑”
黓	黑 弋
黕	黑 冘
黖	黑 旡
黗	黑 屯
黙	里 犬 灬
黚	黑 甘
點	黑 占
黣	黑 每
黤	黑 奄
黦	黑 宛
黨	龸 口 黑
黫	黑 垔
黬	黑 咸
黭	黑 弇
黮	黑 甚
黰	黑 真
黱	月 龹 黑
黲	黑 參
黳	殹 黑
黴	彳 山 一 黑 攵
黵	黑 詹
黶	厭 黑
黷	黑 賣
黸	黑 盧
黺	业 水 冂 分	# 水 交
黽	WX
黿	元 黽
鼀	土 八 黽
鼁	去 黽
鼂	旦 黽
鼃	圭 黽
鼄	朱 黽
鼅	知 黽
鼆	冥 黽
鼇	敖 黽
鼈	敝 黽
鼉	吅 田 一 黽
鼊	辟 黽
鼌	旦 黾
鼏	冖 鼎
鼑	卜 鼎
鼔	壴 攴	# 非“鼓”
鼕	鼓 冬
鼖	卉 鼓
鼘	鼓 ND
鼚	鼓 長
鼛	鼓 咎
鼜	鼓 蚤
鼝	淵 鼓
鼞	鼓 堂
鼟	鼓 登
鼡	VD QD BI
鼣	鼠 犬
鼤	鼠 文
鼥	鼠 犮
鼦	鼠 召
鼧	鼠 它
鼨	鼠 冬
鼪	鼠 生
鼭	鼠 寺
鼮	鼠 廷
鼰	鼠 貝
鼲	鼠 軍
鼳	鼠 狊
鼴	鼠 匽
鼵	鼠 突
鼶	鼠 虒
鼸	鼠 兼
鼺	鼠 畾
鼼	鼻 丩
鼿	鼻 兀
齀	鼻 瓦
齂	鼻 隶
齃	鼻 曷
齅	鼻 臭
齆	鼻 邕
齈	鼻 農
齊	亠 刀 丫 RH ND
齋	齊 小
齌	齊 火
齍	齊 皿
齎	齊 貝
齏	齊 韭
齒	IO
齓	齒 乚
齔	齒 匕
齕	齒 乞
齖	齒 牙
齗	齒 斤
齘	齒 介
齙	齒 包
齚	齒 乍
齛	齒 世
齜	齒 此
齝	齒 台
齞	齒 只
齟	齒 且
齠	齒 召
齡	齒 令
齢	歯 令
齣	齒 句
齤	龹 齒
齥	齒 曳
齦	齒 艮
齧	丰 刀 齒
齨	齒 臼
齩	齒 交
齪	齒 足
齫	齒 困
齬	齒 吾
齭	齒 所
齮	齒 奇
齯	齒 兒
齰	齒 昔
齱	齒 取
齲	齒 禹
齳	齒 軍
齴	齒 彦
齵	齒 禺
齶	齒 咢
齷	齒 屋
齸	齒 益
齹	差 齒
齺	齒 芻
齻	齒 真
齼	齒 楚
齽	齒 禁
齾	獻 齒
龍	SI
龎	厂 龍
龏	龍 廾
龐	广 龍
龑	龍 天
龒	龍 示
龓	有 龍
龔	龍 共
龕	合 龍
龖	龍 龍
龗	霝 龍
龘	龍 龖
龜	丿 WX
龝	禾 龜
龞	敝 龜
龡	龠 欠
龣	龠 录
龤	龠 皆
龥	龠 頁
# 补充字符
﨎	文 隹 又
㘚	口 闞
﨣	走 斗
㳠	氵 达
﨨	金 幸
䞍	贝 青
瓲	瓦 屯
﨏	土 谷
䦅	钅 善
㱮	歹 贵
㥮	忄 芻
䌷	纟 由
﨑	山 竒
䦶	门 争
䝼	貝 青
䱷	虍 魚 攵
﨤	辶 及
﨡	虫 生
䥺	钅 牙
䲣	虍 鱼 攵
䎬	耒 罢
㖞	口 呙
䲡	鱼 酋
䦆	钅 矍
䜩	讠 燕
﨔	木 挙
﨩	阝 島
㧏	扌 LD
㩳	扌 雙
﨧	金 孝
㑳	亻 芻
䥇	金 扇
䦂	钅 扇
斣	蜀 斗
﨟	艹 月 曷
䎱	耒 罷
䦛	門 争
䦷	门 坐
﨓	木 苻
䙡	衤 貴
䙌	衤 贵
扜	扌 于
䦟	門 坐
